File Name,LOC,LLOC,SLOC,Comments,Cyclomatic Complexity,Maintainability Index,h1,h2,h,N1,N2,N,Vocabulary,Volume,Difficulty,Effort,Bugs,Time
147.py,12,11,11,0,4,60.87892298127269,6,15,21,14,28,42,21,184.47733175670794,5.6,1033.0730578375644,0.06149244391890265,57.392947657642466
115.py,11,8,8,0,3,67.88739391861246,4,7,11,5,10,15,11,51.89147427955947,2.857142857142857,148.26135508445563,0.01729715809318649,8.236741949136423
128.py,7,5,5,0,6,71.44887953991449,6,8,14,6,10,16,14,60.91767875292166,3.75,228.44129532345622,0.020305892917640553,12.691183073525345
43.py,8,7,7,0,3,73.70567794030467,2,3,5,2,3,5,5,11.60964047443681,1.0,11.60964047443681,0.0038698801581456034,0.6449800263576005
82.py,21,13,13,0,6,61.752756760489454,4,8,12,7,14,21,12,75.28421251514429,3.5,263.494743803005,0.025094737505048096,14.638596877944723
84.py,3,4,3,0,2,100.0,0,0,0,0,0,0,0,0,0,0,0.0,0.0
60.py,2,2,2,0,1,83.27641167936048,3,5,8,3,6,9,8,27.0,1.8,48.6,0.009,2.7
22.py,2,2,2,0,3,100.0,0,0,0,0,0,0,0,0,0,0,0.0,0.0
23.py,2,2,2,0,1,100.0,0,0,0,0,0,0,0,0,0,0,0.0,0.0
40.py,12,12,12,0,4,64.978140907935,3,7,10,4,7,11,10,36.541209043760986,1.5,54.81181356564148,0.012180403014586996,3.0451007536467487
12.py,6,4,4,0,2,84.48986316429594,1,1,2,1,1,2,2,2.0,0.5,1.0,0.0006666666666666666,0.05555555555555555
111.py,14,12,11,0,5,65.59629429341688,3,6,9,3,6,9,9,28.529325012980813,1.5,42.793987519471216,0.009509775004326938,2.377443751081734
112.py,3,4,3,0,3,76.79891896611021,3,5,8,3,5,8,8,24.0,1.5,36.0,0.008,2.0
79.py,3,2,2,0,1,100.0,0,0,0,0,0,0,0,0,0,0,0.0,0.0
31.py,13,11,11,0,6,62.74629018315213,5,9,14,8,16,24,14,91.37651812938249,4.444444444444445,406.1178583528111,0.03045883937646083,22.56210324182284
7.py,3,2,2,0,3,88.28848882059837,1,2,3,1,2,3,3,4.754887502163469,0.5,2.3774437510817346,0.0015849625007211565,0.1320802083934297
102.py,4,4,4,0,4,72.57820511649285,6,10,16,8,15,23,16,92.0,4.5,414.0,0.030666666666666665,23.0
65.py,10,6,5,2,1,100.0,3,4,7,4,6,10,7,28.07354922057604,2.25,63.16548574629609,0.009357849740192013,3.509193652572005
69.py,13,9,9,0,4,66.84685459352403,4,7,11,5,9,14,11,48.43204266092217,2.5714285714285716,124.53953827094274,0.016144014220307392,6.918863237274596
141.py,19,13,13,0,8,61.72742918372938,6,11,17,6,11,17,17,69.48686830125578,3.0,208.46060490376735,0.023162289433751926,11.581144716875963
44.py,11,9,9,0,3,66.89489175386416,5,5,10,5,10,15,10,49.82892142331044,5.0,249.1446071165522,0.016609640474436815,13.841367062030677
107.py,12,10,10,0,4,64.47266270254313,4,10,14,7,13,20,14,76.14709844115208,2.6,197.98245594699543,0.025382366147050694,10.999025330388635
81.py,17,5,17,0,2,100.0,0,0,0,0,0,0,0,0,0,0,0.0,0.0
103.py,8,6,6,0,2,69.58106919670047,6,8,14,7,13,20,14,76.14709844115208,4.875,371.2171049006164,0.025382366147050694,20.623172494478688
28.py,5,3,3,0,1,100.0,0,0,0,0,0,0,0,0,0,0,0.0,0.0
73.py,2,2,2,0,3,81.69927410397862,3,8,11,4,8,12,11,41.51317942364757,1.5,62.26976913547136,0.01383772647454919,3.4594316186372978
3.py,6,4,3,0,2,78.2610438027938,2,4,6,2,4,6,6,15.509775004326936,1.0,15.509775004326936,0.005169925001442312,0.861654166907052
59.py,22,20,20,0,5,55.034587309360276,6,16,22,14,28,42,22,187.29612798276648,5.25,983.304671909524,0.06243204266092216,54.62803732830689
136.py,8,6,6,0,7,74.52747486526776,2,2,4,2,4,6,4,12.0,2.0,24.0,0.004,1.3333333333333333
140.py,18,15,15,0,4,61.24322293734288,3,8,11,6,12,18,11,62.26976913547136,2.25,140.10698055481055,0.020756589711823786,7.78372114193392
146.py,13,10,10,0,5,64.83236938873519,5,9,14,6,11,17,14,64.72503367497926,3.0555555555555554,197.77093622910328,0.021575011224993085,10.987274234950183
57.py,2,2,2,0,4,79.49312372420772,5,10,15,7,14,21,15,82.0447025077789,3.5,287.15645877722613,0.02734823416925963,15.953136598734785
94.py,16,12,12,0,7,63.668749447472834,5,7,12,5,10,15,12,53.77443751081735,3.5714285714285716,192.0515625386334,0.017924812503605784,10.6695312521463
34.py,2,2,2,0,1,100.0,0,0,0,0,0,0,0,0,0,0,0.0,0.0
123.py,12,8,8,0,4,66.03222611538621,6,8,14,8,16,24,14,91.37651812938249,6.0,548.259108776295,0.03045883937646083,30.45883937646083
11.py,3,2,2,0,3,88.28848882059837,1,2,3,1,2,3,3,4.754887502163469,0.5,2.3774437510817346,0.0015849625007211565,0.1320802083934297
85.py,2,2,2,0,3,84.69319837885878,2,4,6,2,4,6,6,15.509775004326936,1.0,15.509775004326936,0.005169925001442312,0.861654166907052
64.py,5,4,4,0,3,81.72183132055679,1,2,3,1,2,3,3,4.754887502163469,0.5,2.3774437510817346,0.0015849625007211565,0.1320802083934297
91.py,6,4,4,0,2,100.0,0,0,0,0,0,0,0,0,0,0,0.0,0.0
8.py,10,7,7,0,4,71.00462215326401,3,5,8,3,6,9,8,27.0,1.8,48.6,0.009,2.7
98.py,3,3,3,0,3,84.44724042799471,1,2,3,1,2,3,3,4.754887502163469,0.5,2.3774437510817346,0.0015849625007211565,0.1320802083934297
113.py,7,6,7,0,3,74.28529248621352,2,4,6,2,4,6,6,15.509775004326936,1.0,15.509775004326936,0.005169925001442312,0.861654166907052
155.py,4,4,4,0,5,75.12937750960057,3,6,9,4,8,12,9,38.03910001730775,2.0,76.0782000346155,0.012679700005769252,4.226566668589751
158.py,2,3,2,0,1,100.0,0,0,0,0,0,0,0,0,0,0,0.0,0.0
139.py,10,9,9,0,3,67.71588657234646,3,6,9,4,8,12,9,38.03910001730775,2.0,76.0782000346155,0.012679700005769252,4.226566668589751
156.py,19,10,11,0,3,96.76118085120774,3,4,7,3,6,9,7,25.26619429851844,2.25,56.848937171666485,0.008422064766172813,3.158274287314805
86.py,2,2,2,0,2,100.0,0,0,0,0,0,0,0,0,0,0,0.0,0.0
124.py,21,20,20,0,13,51.69851066884805,8,32,40,28,46,74,40,393.82267902166484,5.75,2264.480404374573,0.13127422634055494,125.8044669096985
70.py,11,9,9,0,3,65.52684011362608,6,9,15,7,13,20,15,78.13781191217038,4.333333333333333,338.5971849527383,0.026045937304056792,18.810954719596573
105.py,16,7,16,0,4,74.02503690159936,1,3,4,2,3,5,4,10.0,0.5,5.0,0.0033333333333333335,0.2777777777777778
137.py,10,8,8,0,5,71.29087753082239,2,4,6,2,4,6,6,15.509775004326936,1.0,15.509775004326936,0.005169925001442312,0.861654166907052
133.py,8,6,6,0,2,74.41979541019013,2,4,6,2,4,6,6,15.509775004326936,1.0,15.509775004326936,0.005169925001442312,0.861654166907052
110.py,8,7,7,0,6,68.74891939259918,4,7,11,5,10,15,11,51.89147427955947,2.857142857142857,148.26135508445563,0.01729715809318649,8.236741949136423
77.py,5,4,4,0,1,76.70975417931889,3,5,8,3,6,9,8,27.0,1.8,48.6,0.009,2.7
14.py,5,4,3,0,2,81.85633424453339,1,2,3,1,2,3,3,4.754887502163469,0.5,2.3774437510817346,0.0015849625007211565,0.1320802083934297
97.py,3,2,2,0,1,83.47823723435607,2,5,7,3,6,9,7,25.26619429851844,1.2,30.319433158222125,0.008422064766172813,1.6844129532345624
131.py,7,7,7,1,4,90.59181795179379,3,6,9,4,8,12,9,38.03910001730775,2.0,76.0782000346155,0.012679700005769252,4.226566668589751
55.py,5,5,5,0,2,79.7423427057672,1,2,3,1,2,3,3,4.754887502163469,0.5,2.3774437510817346,0.0015849625007211565,0.1320802083934297
49.py,3,2,2,0,1,100.0,0,0,0,0,0,0,0,0,0,0,0.0,0.0
53.py,3,2,2,0,1,88.5574946685516,1,2,3,1,2,3,3,4.754887502163469,0.5,2.3774437510817346,0.0015849625007211565,0.1320802083934297
121.py,2,2,2,0,4,80.77781576413629,3,9,12,5,10,15,12,53.77443751081735,1.6666666666666667,89.62406251802892,0.017924812503605784,4.9791145843349405
48.py,2,3,2,0,1,82.00171614982087,2,3,5,2,3,5,5,11.60964047443681,1.0,11.60964047443681,0.0038698801581456034,0.6449800263576005
9.py,12,8,8,0,3,73.57307076494241,2,2,4,2,2,4,4,8.0,1.0,8.0,0.0026666666666666666,0.4444444444444444
54.py,2,2,2,0,1,88.5574946685516,1,2,3,1,2,3,3,4.754887502163469,0.5,2.3774437510817346,0.0015849625007211565,0.1320802083934297
160.py,5,5,5,0,2,74.66308527157166,1,6,7,3,6,9,7,25.26619429851844,0.5,12.63309714925922,0.008422064766172813,0.701838730514401
27.py,2,2,2,0,1,100.0,0,0,0,0,0,0,0,0,0,0,0.0,0.0
51.py,3,3,3,0,3,84.44724042799471,1,2,3,1,2,3,3,4.754887502163469,0.5,2.3774437510817346,0.0015849625007211565,0.1320802083934297
159.py,4,4,4,0,1,78.39554672677042,2,4,6,2,4,6,6,15.509775004326936,1.0,15.509775004326936,0.005169925001442312,0.861654166907052
37.py,9,11,9,0,3,69.42371361010727,2,3,5,2,3,5,5,11.60964047443681,1.0,11.60964047443681,0.0038698801581456034,0.6449800263576005
92.py,4,4,4,0,4,77.99203795484058,2,4,6,2,4,6,6,15.509775004326936,1.0,15.509775004326936,0.005169925001442312,0.861654166907052
72.py,8,6,6,0,3,72.95767057350653,3,5,8,3,5,8,8,24.0,1.5,36.0,0.008,2.0
33.py,10,7,8,0,4,100.0,0,0,0,0,0,0,0,0,0,0,0.0,0.0
19.py,20,8,18,0,2,75.28967674449181,1,2,3,1,2,3,3,4.754887502163469,0.5,2.3774437510817346,0.0015849625007211565,0.1320802083934297
100.py,2,2,2,0,2,84.82770130283538,2,4,6,2,4,6,6,15.509775004326936,1.0,15.509775004326936,0.005169925001442312,0.861654166907052
126.py,13,10,10,0,4,67.45805407123096,3,6,9,3,6,9,9,28.529325012980813,1.5,42.793987519471216,0.009509775004326938,2.377443751081734
52.py,2,2,2,0,2,88.42299174457497,1,2,3,1,2,3,3,4.754887502163469,0.5,2.3774437510817346,0.0015849625007211565,0.1320802083934297
50.py,3,2,2,0,2,81.83377702795524,3,8,11,4,8,12,11,41.51317942364757,1.5,62.26976913547136,0.01383772647454919,3.4594316186372978
119.py,15,14,14,0,3,61.83526575483543,4,11,15,6,11,17,15,66.41714012534482,2.0,132.83428025068963,0.02213904670844827,7.379682236149424
108.py,8,7,7,0,3,69.58758862472287,4,7,11,5,8,13,11,44.97261104228487,2.2857142857142856,102.79453952522255,0.01499087034742829,5.710807751401252
163.py,5,4,4,0,3,76.27320603401535,3,6,9,3,6,9,9,28.529325012980813,1.5,42.793987519471216,0.009509775004326938,2.377443751081734
38.py,9,8,7,0,5,69.94141346234306,2,5,7,3,6,9,7,25.26619429851844,1.2,30.319433158222125,0.008422064766172813,1.6844129532345624
5.py,12,8,8,0,3,77.78870274027774,1,1,2,1,1,2,2,2.0,0.5,1.0,0.0006666666666666666,0.05555555555555555
142.py,5,3,4,0,5,74.68151961551501,5,11,16,9,18,27,16,108.0,4.090909090909091,441.8181818181818,0.036,24.545454545454547
4.py,6,4,4,0,2,76.57525125534227,2,6,8,3,6,9,8,27.0,1.0,27.0,0.009,1.5
58.py,2,2,2,0,1,100.0,0,0,0,0,0,0,0,0,0,0,0.0,0.0
93.py,7,7,6,0,3,76.42020806643173,1,2,3,1,2,3,3,4.754887502163469,0.5,2.3774437510817346,0.0015849625007211565,0.1320802083934297
29.py,5,3,3,0,3,100.0,0,0,0,0,0,0,0,0,0,0,0.0,0.0
127.py,20,18,18,0,9,56.3191693699994,8,15,23,11,22,33,23,149.27754454988144,5.866666666666666,875.7615946926377,0.04975918151662715,48.65342192736876
104.py,5,4,4,0,3,76.79891896611021,3,5,8,3,5,8,8,24.0,1.5,36.0,0.008,2.0
99.py,14,11,11,0,4,65.414526095638,4,7,11,4,8,12,11,41.51317942364757,2.2857142857142856,94.88726725405158,0.01383772647454919,5.27151484744731
68.py,12,9,9,0,5,67.71147672459561,3,6,9,4,7,11,9,34.86917501586544,1.75,61.021056277764515,0.011623058338621813,3.3900586820980285
135.py,10,8,8,0,3,72.44064369438814,2,3,5,2,3,5,5,11.60964047443681,1.0,11.60964047443681,0.0038698801581456034,0.6449800263576005
71.py,10,7,7,0,4,64.36429869935884,7,19,26,17,34,51,26,239.7224256251957,6.2631578947368425,1501.41940259991,0.07990747520839857,83.41218903332833
89.py,5,4,4,0,3,76.27320603401535,3,6,9,3,6,9,9,28.529325012980813,1.5,42.793987519471216,0.009509775004326938,2.377443751081734
20.py,16,11,11,0,3,64.99380095474905,3,7,10,5,10,15,10,49.82892142331044,2.142857142857143,106.77626019280808,0.016609640474436815,5.932014455156004
87.py,3,4,3,0,4,78.87279827045312,2,3,5,2,3,5,5,11.60964047443681,1.0,11.60964047443681,0.0038698801581456034,0.6449800263576005
25.py,14,11,11,0,3,64.99380095474905,5,5,10,5,10,15,10,49.82892142331044,5.0,249.1446071165522,0.016609640474436815,13.841367062030677
117.py,11,8,9,0,5,71.29087753082239,2,4,6,2,4,6,6,15.509775004326936,1.0,15.509775004326936,0.005169925001442312,0.861654166907052
148.py,17,12,11,1,5,79.41473823900046,6,10,16,7,14,21,16,84.0,4.2,352.8,0.028,19.6
62.py,2,3,2,0,2,84.58174335197131,1,2,3,1,2,3,3,4.754887502163469,0.5,2.3774437510817346,0.0015849625007211565,0.1320802083934297
134.py,6,5,5,0,3,73.69639031151141,4,6,10,4,6,10,10,33.219280948873624,2.0,66.43856189774725,0.01107309364962454,3.691031216541514
42.py,2,2,2,0,2,88.42299174457497,1,2,3,1,2,3,3,4.754887502163469,0.5,2.3774437510817346,0.0015849625007211565,0.1320802083934297
138.py,2,2,2,0,2,81.15521184267224,3,8,11,5,10,15,11,51.89147427955947,1.875,97.296514274174,0.01729715809318649,5.405361904120777
24.py,4,4,4,0,3,75.52054972455686,4,6,10,4,7,11,10,36.541209043760986,2.3333333333333335,85.26282110210897,0.012180403014586996,4.736823394561609
144.py,13,8,8,3,1,96.75220378287875,3,8,11,4,8,12,11,41.51317942364757,1.5,62.26976913547136,0.01383772647454919,3.4594316186372978
120.py,6,6,5,0,2,75.75441761107395,2,2,4,2,3,5,4,10.0,1.5,15.0,0.0033333333333333335,0.8333333333333334
114.py,11,9,9,0,3,70.44404409360986,2,4,6,2,4,6,6,15.509775004326936,1.0,15.509775004326936,0.005169925001442312,0.861654166907052
0.py,9,6,6,0,3,74.28529248621352,2,4,6,2,4,6,6,15.509775004326936,1.0,15.509775004326936,0.005169925001442312,0.861654166907052
17.py,4,4,3,0,2,100.0,0,0,0,0,0,0,0,0,0,0,0.0,0.0
32.py,16,13,13,0,4,60.1723656641182,6,14,20,11,21,32,20,138.3016990363956,4.5,622.3576456637802,0.0461005663454652,34.5754247590989
101.py,6,5,5,0,2,82.37587162552974,1,1,2,1,1,2,2,2.0,0.5,1.0,0.0006666666666666666,0.05555555555555555
41.py,2,2,2,0,1,89.95803027710804,1,1,2,1,2,3,2,3.0,1.0,3.0,0.001,0.16666666666666666
35.py,2,2,2,0,1,100.0,0,0,0,0,0,0,0,0,0,0,0.0,0.0
90.py,4,4,4,0,2,81.85633424453339,1,2,3,1,2,3,3,4.754887502163469,0.5,2.3774437510817346,0.0015849625007211565,0.1320802083934297
18.py,14,12,12,0,5,62.38405740754426,6,9,15,8,13,21,15,82.0447025077789,4.333333333333333,355.5270442003752,0.02734823416925963,19.7515024555764
116.py,2,3,2,0,1,100.0,0,0,0,0,0,0,0,0,0,0,0.0,0.0
66.py,2,2,2,0,4,100.0,0,0,0,0,0,0,0,0,0,0,0.0,0.0
36.py,6,6,6,0,4,69.63245789928568,4,10,14,6,12,18,14,68.53238859703687,2.4,164.4777326328885,0.022844129532345624,9.13765181293825
47.py,9,8,8,0,2,67.17605463980098,6,8,14,6,12,18,14,68.53238859703687,4.5,308.3957486866659,0.022844129532345624,17.133097149259218
16.py,2,2,2,0,3,100.0,0,0,0,0,0,0,0,0,0,0,0.0,0.0
63.py,13,11,11,0,5,64.1703669808727,2,8,10,6,12,18,10,59.794705707972525,1.5,89.69205856195879,0.019931568569324175,4.9828921423310435
26.py,7,5,5,0,3,79.60783978179059,1,2,3,1,2,3,3,4.754887502163469,0.5,2.3774437510817346,0.0015849625007211565,0.1320802083934297
150.py,14,11,11,0,5,64.72479510679582,3,7,10,5,10,15,10,49.82892142331044,2.142857142857143,106.77626019280808,0.016609640474436815,5.932014455156004
13.py,4,4,4,1,2,100.0,2,3,5,2,4,6,5,13.931568569324174,1.3333333333333333,18.575424759098897,0.004643856189774725,1.0319680421721609
161.py,6,6,5,0,5,76.0294740244271,2,2,4,2,2,4,4,8.0,1.0,8.0,0.0026666666666666666,0.4444444444444444
109.py,11,9,8,0,2,69.25092510487947,3,5,8,3,5,8,8,24.0,1.5,36.0,0.008,2.0
151.py,2,2,2,0,6,80.31255242500448,5,7,12,5,11,16,12,57.359400011538504,3.9285714285714284,225.34050004532983,0.01911980000384617,12.518916669184991
130.py,9,8,9,0,3,64.92171803694012,5,13,18,11,22,33,18,137.6075250475963,4.230769230769231,582.1856828936767,0.04586917501586544,32.343649049648704
67.py,4,3,3,0,3,84.44724042799471,1,2,3,1,2,3,3,4.754887502163469,0.5,2.3774437510817346,0.0015849625007211565,0.1320802083934297
45.py,2,2,2,0,1,85.28853641650139,1,4,5,2,4,6,5,13.931568569324174,0.5,6.965784284662087,0.004643856189774725,0.3869880158145604
88.py,3,2,2,0,1,82.23287595213422,4,7,11,4,7,11,11,38.053747805010275,2.0,76.10749561002055,0.012684582601670092,4.228194200556697
152.py,2,2,2,0,2,88.42299174457497,1,2,3,1,2,3,3,4.754887502163469,0.5,2.3774437510817346,0.0015849625007211565,0.1320802083934297
15.py,2,2,2,0,1,88.5574946685516,1,2,3,1,2,3,3,4.754887502163469,0.5,2.3774437510817346,0.0015849625007211565,0.1320802083934297
125.py,14,9,8,3,8,94.96061078349346,2,7,9,4,8,12,9,38.03910001730775,1.1428571428571428,43.47325716263743,0.012679700005769252,2.415180953479857
78.py,3,3,3,0,3,84.44724042799471,1,2,3,1,2,3,3,4.754887502163469,0.5,2.3774437510817346,0.0015849625007211565,0.1320802083934297
145.py,8,7,7,0,1,71.76630155993837,3,5,8,3,5,8,8,24.0,1.5,36.0,0.008,2.0
157.py,5,4,4,2,1,100.0,3,8,11,5,10,15,11,51.89147427955947,1.875,97.296514274174,0.01729715809318649,5.405361904120777
6.py,17,14,14,0,4,64.63979020821802,3,4,7,3,6,9,7,25.26619429851844,2.25,56.848937171666485,0.008422064766172813,3.158274287314805
1.py,19,15,15,0,5,60.76329483255459,3,7,10,7,14,21,10,69.76048999263462,3.0,209.28146997790384,0.02325349666421154,11.62674833210577
46.py,9,7,7,0,3,69.152428164529,2,9,11,5,10,15,11,51.89147427955947,1.1111111111111112,57.65719364395497,0.01729715809318649,3.203177424664165
162.py,9,6,6,0,2,78.01508585192973,1,2,3,1,2,3,3,4.754887502163469,0.5,2.3774437510817346,0.0015849625007211565,0.1320802083934297
96.py,21,13,13,5,6,90.64705095082473,5,9,14,5,10,15,14,57.110323830864054,2.7777777777777777,158.6397884190668,0.019036774610288017,8.813321578837044
153.py,14,11,11,0,7,68.0049415985883,2,4,6,2,4,6,6,15.509775004326936,1.0,15.509775004326936,0.005169925001442312,0.861654166907052
122.py,2,3,2,0,3,82.18657218713894,1,3,4,2,3,5,4,10.0,0.5,5.0,0.0033333333333333335,0.2777777777777778
30.py,2,3,2,0,1,84.71624627594792,1,2,3,1,2,3,3,4.754887502163469,0.5,2.3774437510817346,0.0015849625007211565,0.1320802083934297
95.py,10,7,7,0,7,69.29298165390556,3,8,11,4,8,12,11,41.51317942364757,1.5,62.26976913547136,0.01383772647454919,3.4594316186372978
83.py,4,4,4,0,2,71.24940610582667,5,15,20,12,24,36,20,155.58941141594505,4.0,622.3576456637802,0.05186313713864835,34.5754247590989
80.py,9,7,7,0,4,69.96225717945212,3,6,9,4,8,12,9,38.03910001730775,2.0,76.0782000346155,0.012679700005769252,4.226566668589751
76.py,9,9,9,0,4,66.90281846308689,4,5,9,5,10,15,9,47.548875021634686,4.0,190.19550008653874,0.01584962500721156,10.566416671474375
39.py,22,17,17,0,8,58.03061239323693,6,13,19,9,16,25,19,106.19818783608963,3.6923076923076925,392.11638585633096,0.03539939594536321,21.784243658685053
129.py,10,7,7,0,4,72.69041470071554,2,4,6,2,4,6,6,15.509775004326936,1.0,15.509775004326936,0.005169925001442312,0.861654166907052
154.py,7,7,7,0,3,69.152428164529,3,8,11,5,10,15,11,51.89147427955947,1.875,97.296514274174,0.01729715809318649,5.405361904120777
21.py,9,6,6,0,2,71.9562338891291,3,6,9,4,7,11,9,34.86917501586544,1.75,61.021056277764515,0.011623058338621813,3.3900586820980285
2.py,2,2,2,0,2,85.15403349252477,2,3,5,2,4,6,5,13.931568569324174,1.3333333333333333,18.575424759098897,0.004643856189774725,1.0319680421721609
118.py,11,8,8,0,6,65.01955958634022,7,13,20,9,18,27,20,116.69205856195879,4.846153846153846,565.5076684156464,0.03889735285398626,31.417092689758135
143.py,15,13,13,0,7,62.679538453612146,5,8,13,5,10,15,13,55.506595772116384,3.125,173.4581117878637,0.01850219859070546,9.636561765992427
106.py,14,12,12,0,3,63.937755295426065,4,8,12,5,10,15,12,53.77443751081735,2.5,134.43609377704337,0.017924812503605784,7.468671876502409
75.py,21,15,15,0,9,59.15348444176169,6,14,20,8,16,24,20,103.72627427729671,3.4285714285714284,355.63294037930297,0.0345754247590989,19.757385576627943
74.py,5,4,4,0,4,81.58732839658019,1,2,3,1,2,3,3,4.754887502163469,0.5,2.3774437510817346,0.0015849625007211565,0.1320802083934297
56.py,12,10,10,0,5,66.44872847079279,2,7,9,4,8,12,9,38.03910001730775,1.1428571428571428,43.47325716263743,0.012679700005769252,2.415180953479857
132.py,14,11,11,0,4,65.84783514660505,3,5,8,4,8,12,8,36.0,2.4,86.39999999999999,0.012,4.8
10.py,10,10,8,0,3,65.8967395002637,4,6,10,6,9,15,10,49.82892142331044,3.0,149.4867642699313,0.016609640474436815,8.304820237218406
61.py,13,10,10,0,4,65.90466620948642,4,5,9,5,10,15,9,47.548875021634686,4.0,190.19550008653874,0.01584962500721156,10.566416671474375
149.py,4,4,3,0,3,78.1265408788172,2,4,6,2,4,6,6,15.509775004326936,1.0,15.509775004326936,0.005169925001442312,0.861654166907052
