File Name,LOC,LLOC,SLOC,Comments,Cyclomatic Complexity,Maintainability Index,h1,h2,h,N1,N2,N,Vocabulary,Volume,Difficulty,Effort,Bugs,Time
79.py,5,5,5,0,3,76.012549340051,2,4,6,2,4,6,6,15.509775004326936,1.0,15.509775004326936,0.005169925001442312,0.861654166907052
110.py,4,4,4,0,6,74.05054264672424,4,7,11,5,10,15,11,51.89147427955947,2.857142857142857,148.26135508445563,0.01729715809318649,8.236741949136423
119.py,5,5,5,0,3,73.01862506517085,3,8,11,4,8,12,11,41.51317942364757,1.5,62.26976913547136,0.01383772647454919,3.4594316186372978
84.py,2,2,2,0,1,100.0,0,0,0,0,0,0,0,0,0,0,0.0,0.0
30.py,2,3,2,0,1,84.71624627594792,1,2,3,1,2,3,3,4.754887502163469,0.5,2.3774437510817346,0.0015849625007211565,0.1320802083934297
135.py,5,5,5,0,3,73.20852939104878,3,5,8,5,8,13,8,39.0,2.4,93.6,0.013,5.199999999999999
76.py,11,8,8,0,3,69.77839958079733,1,4,5,4,8,12,5,27.863137138648348,1.0,27.863137138648348,0.00928771237954945,1.5479520632582415
115.py,3,3,3,0,2,84.58174335197131,1,2,3,1,2,3,3,4.754887502163469,0.5,2.3774437510817346,0.0015849625007211565,0.1320802083934297
157.py,4,4,4,0,1,74.72305726660727,3,8,11,5,10,15,11,51.89147427955947,1.875,97.296514274174,0.01729715809318649,5.405361904120777
116.py,2,3,2,0,1,100.0,0,0,0,0,0,0,0,0,0,0,0.0,0.0
21.py,14,9,9,0,4,66.52866147888739,4,8,12,5,10,15,12,53.77443751081735,2.5,134.43609377704337,0.017924812503605784,7.468671876502409
149.py,2,3,2,0,3,80.85194998625511,2,4,6,2,4,6,6,15.509775004326936,1.0,15.509775004326936,0.005169925001442312,0.861654166907052
36.py,2,2,2,0,4,80.88620599471905,3,8,11,5,10,15,11,51.89147427955947,1.875,97.296514274174,0.01729715809318649,5.405361904120777
137.py,10,8,8,0,3,72.3400774537363,2,2,4,2,4,6,4,12.0,2.0,24.0,0.004,1.3333333333333333
150.py,8,6,6,0,4,70.18688602520882,5,9,14,5,10,15,14,57.110323830864054,2.7777777777777777,158.6397884190668,0.019036774610288017,8.813321578837044
67.py,8,8,8,0,5,71.29087753082239,2,4,6,2,4,6,6,15.509775004326936,1.0,15.509775004326936,0.005169925001442312,0.861654166907052
1.py,20,15,15,0,5,61.2320571337837,3,7,10,6,12,18,10,59.794705707972525,2.5714285714285716,153.75781467764364,0.019931568569324175,8.542100815424646
82.py,9,9,9,0,4,67.31561689475312,4,7,11,4,8,12,11,41.51317942364757,2.2857142857142856,94.88726725405158,0.01383772647454919,5.27151484744731
98.py,2,2,2,0,3,88.28848882059837,1,2,3,1,2,3,3,4.754887502163469,0.5,2.3774437510817346,0.0015849625007211565,0.1320802083934297
142.py,2,2,2,0,4,80.33177786879591,3,8,11,6,12,18,11,62.26976913547136,2.25,140.10698055481055,0.020756589711823786,7.78372114193392
83.py,5,5,5,0,3,72.23166964930512,5,7,12,5,10,15,12,53.77443751081735,3.5714285714285716,192.0515625386334,0.017924812503605784,10.6695312521463
43.py,7,7,7,0,3,73.70567794030467,2,3,5,2,3,5,5,11.60964047443681,1.0,11.60964047443681,0.0038698801581456034,0.6449800263576005
16.py,4,4,4,0,2,79.14180411840633,2,3,5,2,3,5,5,11.60964047443681,1.0,11.60964047443681,0.0038698801581456034,0.6449800263576005
104.py,2,2,2,0,4,88.15398589662178,1,2,3,1,2,3,3,4.754887502163469,0.5,2.3774437510817346,0.0015849625007211565,0.1320802083934297
81.py,12,10,12,0,4,67.50702737303844,3,4,7,4,6,10,7,28.07354922057604,2.25,63.16548574629609,0.009357849740192013,3.509193652572005
129.py,21,17,17,0,11,56.15156685729755,7,17,24,12,24,36,24,165.05865002596164,4.9411764705882355,815.58391777534,0.05501955000865388,45.31021765418555
22.py,5,4,3,0,1,100.0,0,0,0,0,0,0,0,0,0,0,0.0,0.0
63.py,8,7,7,0,3,69.27576528494643,3,7,10,5,10,15,10,49.82892142331044,2.142857142857143,106.77626019280808,0.016609640474436815,5.932014455156004
118.py,8,8,8,0,6,65.94933850114126,4,11,15,8,14,22,15,85.95159310338741,2.5454545454545454,218.78587335407704,0.02865053103446247,12.154770741893168
126.py,10,8,8,0,4,71.42538045479901,2,4,6,2,4,6,6,15.509775004326936,1.0,15.509775004326936,0.005169925001442312,0.861654166907052
86.py,2,2,2,0,3,100.0,0,0,0,0,0,0,0,0,0,0,0.0,0.0
121.py,2,2,2,0,3,84.69319837885878,2,4,6,2,4,6,6,15.509775004326936,1.0,15.509775004326936,0.005169925001442312,0.861654166907052
53.py,5,5,5,0,2,79.7423427057672,1,2,3,1,2,3,3,4.754887502163469,0.5,2.3774437510817346,0.0015849625007211565,0.1320802083934297
35.py,4,4,4,0,2,84.48986316429594,1,1,2,1,1,2,2,2.0,0.5,1.0,0.0006666666666666666,0.05555555555555555
17.py,6,5,4,0,1,100.0,0,0,0,0,0,0,0,0,0,0,0.0,0.0
15.py,2,2,2,0,1,88.5574946685516,1,2,3,1,2,3,3,4.754887502163469,0.5,2.3774437510817346,0.0015849625007211565,0.1320802083934297
40.py,19,17,17,0,7,55.85575438000631,6,17,23,16,32,48,23,217.13097389073664,5.647058823529412,1226.1513819712188,0.07237699129691222,68.11952122062327
27.py,2,2,2,0,3,100.0,0,0,0,0,0,0,0,0,0,0,0.0,0.0
41.py,4,4,4,0,3,75.66297935775616,4,5,9,4,7,11,9,34.86917501586544,2.8,97.63369004442322,0.011623058338621813,5.424093891356845
93.py,6,6,6,0,3,74.28529248621352,2,4,6,2,4,6,6,15.509775004326936,1.0,15.509775004326936,0.005169925001442312,0.861654166907052
7.py,8,7,6,0,2,76.55471099040834,1,2,3,1,2,3,3,4.754887502163469,0.5,2.3774437510817346,0.0015849625007211565,0.1320802083934297
131.py,8,8,8,0,4,71.42538045479901,2,4,6,2,4,6,6,15.509775004326936,1.0,15.509775004326936,0.005169925001442312,0.861654166907052
160.py,8,8,7,0,2,100.0,0,0,0,0,0,0,0,0,0,0,0.0,0.0
24.py,5,5,5,0,3,73.40655818579066,4,6,10,4,7,11,10,36.541209043760986,2.3333333333333335,85.26282110210897,0.012180403014586996,4.736823394561609
70.py,5,8,5,0,3,72.44064369438814,2,3,5,2,3,5,5,11.60964047443681,1.0,11.60964047443681,0.0038698801581456034,0.6449800263576005
148.py,9,8,8,0,3,71.88621556846499,2,3,5,2,4,6,5,13.931568569324174,1.3333333333333333,18.575424759098897,0.004643856189774725,1.0319680421721609
42.py,9,10,9,0,3,73.041182281749,1,2,3,1,2,3,3,4.754887502163469,0.5,2.3774437510817346,0.0015849625007211565,0.1320802083934297
140.py,16,14,14,0,3,58.51892985135122,5,16,21,15,30,45,21,197.65428402504423,4.6875,926.5044563673948,0.0658847613416814,51.4724697981886
97.py,2,2,2,0,3,81.82261122439607,3,7,10,4,8,12,10,39.863137138648355,1.7142857142857142,68.33680652339717,0.013287712379549451,3.796489251299843
102.py,7,7,7,0,3,69.07950779376786,5,5,10,6,10,16,10,53.1508495181978,5.0,265.754247590989,0.017716949839399268,14.764124866166055
18.py,2,3,2,0,3,77.85802571137496,3,8,11,4,8,12,11,41.51317942364757,1.5,62.26976913547136,0.01383772647454919,3.4594316186372978
5.py,9,5,4,1,3,100.0,1,1,2,1,1,2,2,2.0,0.5,1.0,0.0006666666666666666,0.05555555555555555
106.py,5,3,3,0,3,77.3027976465094,4,6,10,5,10,15,10,49.82892142331044,3.3333333333333335,166.09640474436813,0.016609640474436815,9.227578041353786
128.py,13,13,13,0,5,62.095198309791094,6,7,13,7,12,19,13,70.30835464468075,5.142857142857143,361.5858238869296,0.02343611821489358,20.088101327051643
145.py,2,3,2,0,2,100.0,0,0,0,0,0,0,0,0,0,0,0.0,0.0
10.py,6,7,6,0,4,69.08743450299058,4,5,9,7,9,16,9,50.718800023077,3.6,182.5876800830772,0.016906266674359,10.1437600046154
80.py,5,4,4,0,5,71.30061371790211,5,15,20,10,21,31,20,133.97977094150824,3.5,468.9291982952788,0.04465992364716941,26.05162212751549
2.py,8,6,6,0,3,73.15949612850216,3,4,7,3,5,8,7,22.458839376460833,1.875,42.11032383086406,0.007486279792153611,2.3394624350480036
50.py,2,2,2,0,2,81.95711414837267,3,7,10,4,8,12,10,39.863137138648355,1.7142857142857142,68.33680652339717,0.013287712379549451,3.796489251299843
162.py,5,3,3,0,2,87.21527227173385,1,1,2,1,1,2,2,2.0,0.5,1.0,0.0006666666666666666,0.05555555555555555
96.py,9,9,9,0,3,66.56675566883446,5,8,13,5,10,15,13,55.506595772116384,3.125,173.4581117878637,0.01850219859070546,9.636561765992427
61.py,10,10,10,0,5,65.07330552638736,4,6,10,6,12,18,10,59.794705707972525,4.0,239.1788228318901,0.019931568569324175,13.28771237954945
23.py,5,5,5,0,2,100.0,0,0,0,0,0,0,0,0,0,0,0.0,0.0
29.py,5,4,3,0,1,100.0,0,0,0,0,0,0,0,0,0,0,0.0,0.0
4.py,7,5,5,0,2,76.14705226402761,2,4,6,2,4,6,6,15.509775004326936,1.0,15.509775004326936,0.005169925001442312,0.861654166907052
89.py,2,2,2,0,3,81.82261122439607,3,7,10,4,8,12,10,39.863137138648355,1.7142857142857142,68.33680652339717,0.013287712379549451,3.796489251299843
48.py,2,3,2,0,1,82.00171614982087,2,3,5,2,3,5,5,11.60964047443681,1.0,11.60964047443681,0.0038698801581456034,0.6449800263576005
161.py,2,3,2,0,7,82.32712567651546,2,2,4,2,2,4,4,8.0,1.0,8.0,0.0026666666666666666,0.4444444444444444
146.py,9,9,9,0,5,65.83052164233564,5,9,14,6,11,17,14,64.72503367497926,3.0555555555555554,197.77093622910328,0.021575011224993085,10.987274234950183
65.py,5,5,4,0,1,74.47719364500986,3,4,7,4,6,10,7,28.07354922057604,2.25,63.16548574629609,0.009357849740192013,3.509193652572005
108.py,2,2,2,0,4,88.15398589662178,1,2,3,1,2,3,3,4.754887502163469,0.5,2.3774437510817346,0.0015849625007211565,0.1320802083934297
136.py,14,10,10,1,8,81.28428063864254,4,9,13,8,16,24,13,88.81055323538621,3.5555555555555554,315.7708559480398,0.029603517745128736,17.542825330446657
95.py,11,9,9,0,8,68.64573311601544,2,5,7,3,5,8,7,22.458839376460833,1.0,22.458839376460833,0.007486279792153611,1.2477132986922685
0.py,6,4,4,0,2,75.3904566483311,3,7,10,4,8,12,10,39.863137138648355,1.7142857142857142,68.33680652339717,0.013287712379549451,3.796489251299843
99.py,6,6,6,0,4,68.67118102913474,6,11,17,8,15,23,17,94.01164534875782,4.090909090909091,384.59309460855474,0.031337215116252606,21.366283033808596
12.py,7,5,5,0,2,100.0,0,0,0,0,0,0,0,0,0,0,0.0,0.0
69.py,8,8,8,0,3,72.44064369438814,2,3,5,2,3,5,5,11.60964047443681,1.0,11.60964047443681,0.0038698801581456034,0.6449800263576005
8.py,12,10,10,0,2,100.0,0,0,0,0,0,0,0,0,0,0,0.0,0.0
107.py,14,12,11,0,4,62.666928082211555,4,11,15,7,13,20,15,78.13781191217038,2.3636363636363638,184.68937361058454,0.026045937304056792,10.260520756143585
60.py,5,5,5,0,2,73.27646510956488,4,6,10,4,8,12,10,39.863137138648355,2.6666666666666665,106.3016990363956,0.013287712379549451,5.905649946466422
101.py,2,2,2,0,3,100.0,0,0,0,0,0,0,0,0,0,0,0.0,0.0
133.py,5,3,3,0,2,84.58174335197131,1,2,3,1,2,3,3,4.754887502163469,0.5,2.3774437510817346,0.0015849625007211565,0.1320802083934297
72.py,2,3,2,0,2,78.25712463555394,4,7,11,4,7,11,11,38.053747805010275,2.0,76.10749561002055,0.012684582601670092,4.228194200556697
139.py,7,7,7,0,2,71.4754535562128,2,5,7,3,6,9,7,25.26619429851844,1.2,30.319433158222125,0.008422064766172813,1.6844129532345624
56.py,9,7,7,0,4,69.35106524502372,4,6,10,5,9,14,10,46.50699332842308,3.0,139.52097998526924,0.01550233110947436,7.75116555473718
55.py,8,7,8,0,3,69.8533553783396,3,6,9,5,8,13,9,41.20902501875006,2.0,82.41805003750012,0.013736341672916687,4.578780557638896
66.py,2,2,2,0,3,100.0,0,0,0,0,0,0,0,0,0,0,0.0,0.0
49.py,2,2,2,0,1,100.0,0,0,0,0,0,0,0,0,0,0,0.0,0.0
39.py,19,15,15,0,3,60.4674499345959,5,11,16,7,14,21,16,84.0,3.1818181818181817,267.27272727272725,0.028,14.848484848484848
147.py,9,9,9,0,3,63.35861647451788,4,13,17,13,26,39,17,159.41105080876326,4.0,637.644203235053,0.05313701693625442,35.42467795750295
156.py,13,9,10,0,3,68.96007710115393,3,4,7,3,6,9,7,25.26619429851844,2.25,56.848937171666485,0.008422064766172813,3.158274287314805
32.py,21,16,15,0,6,83.35238061570483,6,16,22,12,23,35,22,156.0801066523054,4.3125,673.095459938067,0.05202670221743513,37.394192218781505
154.py,5,5,5,0,3,76.012549340051,2,4,6,2,4,6,6,15.509775004326936,1.0,15.509775004326936,0.005169925001442312,0.861654166907052
123.py,8,7,7,0,5,66.33409270341362,7,9,16,10,20,30,16,120.0,7.777777777777778,933.3333333333334,0.04,51.851851851851855
113.py,4,3,4,0,6,75.23831072119471,2,10,12,8,16,24,12,86.03910001730776,1.6,137.66256002769242,0.028679700005769252,7.647920001538468
68.py,9,6,9,0,4,74.15078956223692,2,4,6,2,4,6,6,15.509775004326936,1.0,15.509775004326936,0.005169925001442312,0.861654166907052
114.py,10,10,10,0,4,67.62559636858127,3,5,8,3,6,9,8,27.0,1.8,48.6,0.009,2.7
78.py,3,3,3,0,2,84.58174335197131,1,2,3,1,2,3,3,4.754887502163469,0.5,2.3774437510817346,0.0015849625007211565,0.1320802083934297
77.py,4,4,4,0,1,75.667389205507,3,6,9,4,8,12,9,38.03910001730775,2.0,76.0782000346155,0.012679700005769252,4.226566668589751
54.py,2,2,2,0,1,88.5574946685516,1,2,3,1,2,3,3,4.754887502163469,0.5,2.3774437510817346,0.0015849625007211565,0.1320802083934297
11.py,2,2,2,0,3,88.28848882059837,1,2,3,1,2,3,3,4.754887502163469,0.5,2.3774437510817346,0.0015849625007211565,0.1320802083934297
163.py,4,4,4,0,4,73.6475213515196,5,9,14,6,11,17,14,64.72503367497926,3.0555555555555554,197.77093622910328,0.021575011224993085,10.987274234950183
9.py,6,4,4,0,1,100.0,0,0,0,0,0,0,0,0,0,0,0.0,0.0
134.py,7,5,5,0,3,73.54898781898997,3,6,9,4,7,11,9,34.86917501586544,1.75,61.021056277764515,0.011623058338621813,3.3900586820980285
130.py,12,10,10,0,4,61.66419300441181,7,15,22,15,28,43,22,191.75555960140377,6.533333333333333,1252.802989395838,0.0639185198671346,69.60016607754656
62.py,2,3,2,0,2,84.58174335197131,1,2,3,1,2,3,3,4.754887502163469,0.5,2.3774437510817346,0.0015849625007211565,0.1320802083934297
103.py,6,6,6,0,2,71.9562338891291,4,5,9,4,7,11,9,34.86917501586544,2.8,97.63369004442322,0.011623058338621813,5.424093891356845
45.py,9,8,9,0,5,66.85916098012385,4,9,13,6,12,18,13,66.60791492653966,2.6666666666666665,177.62110647077242,0.022202638308846556,9.867839248376246
59.py,8,8,8,0,3,68.15316067222922,5,4,9,5,10,15,9,47.548875021634686,6.25,297.1804688852168,0.01584962500721156,16.51002604917871
71.py,6,6,6,0,2,67.54785696041495,7,18,25,11,21,32,25,148.60339807279118,4.083333333333333,606.7972087972306,0.04953446602426373,33.71095604429059
143.py,10,9,9,0,3,66.56675566883446,5,8,13,5,10,15,13,55.506595772116384,3.125,173.4581117878637,0.01850219859070546,9.636561765992427
155.py,5,5,5,0,3,76.012549340051,2,4,6,2,4,6,6,15.509775004326936,1.0,15.509775004326936,0.005169925001442312,0.861654166907052
75.py,15,12,12,0,7,60.90514736283883,7,16,23,9,18,27,23,122.13617281353935,3.9375,480.9111804533112,0.040712057604513116,26.717287802961735
6.py,15,13,13,0,5,64.13071457845106,3,5,8,4,8,12,8,36.0,2.4,86.39999999999999,0.012,4.8
26.py,12,12,12,0,4,65.89833951474381,3,5,8,3,6,9,8,27.0,1.8,48.6,0.009,2.7
87.py,8,7,7,0,4,70.88605315772118,3,4,7,4,6,10,7,28.07354922057604,2.25,63.16548574629609,0.009357849740192013,3.509193652572005
28.py,10,8,8,0,4,77.65419981630114,1,1,2,1,1,2,2,2.0,0.5,1.0,0.0006666666666666666,0.05555555555555555
90.py,9,9,9,0,4,73.90483161137286,1,2,3,1,2,3,3,4.754887502163469,0.5,2.3774437510817346,0.0015849625007211565,0.1320802083934297
13.py,9,9,9,0,5,65.60269547875872,5,5,10,7,14,21,10,69.76048999263462,7.0,488.3234299484423,0.02325349666421154,27.129079441580128
151.py,2,2,2,0,5,79.66296815958566,6,9,15,6,13,19,15,74.23092131656186,4.333333333333333,321.6673257051014,0.024743640438853954,17.870406983616746
141.py,11,5,9,0,7,70.1544718116177,5,14,19,7,14,21,19,89.20647778231529,2.5,223.01619445578822,0.029735492594105097,12.389788580877124
20.py,10,6,6,0,1,73.32130502296063,1,5,6,3,6,9,6,23.264662506490403,0.6,13.95879750389424,0.007754887502163467,0.7754887502163467
64.py,4,4,4,0,1,81.99083716851001,1,2,3,1,2,3,3,4.754887502163469,0.5,2.3774437510817346,0.0015849625007211565,0.1320802083934297
120.py,5,3,3,0,1,100.0,0,0,0,0,0,0,0,0,0,0,0.0,0.0
144.py,4,4,4,0,1,75.40162245189028,3,8,11,4,8,12,11,41.51317942364757,1.5,62.26976913547136,0.01383772647454919,3.4594316186372978
74.py,4,3,3,0,2,84.58174335197131,1,2,3,1,2,3,3,4.754887502163469,0.5,2.3774437510817346,0.0015849625007211565,0.1320802083934297
47.py,5,3,3,0,1,100.0,0,0,0,0,0,0,0,0,0,0,0.0,0.0
152.py,2,3,2,0,1,84.71624627594792,1,2,3,1,2,3,3,4.754887502163469,0.5,2.3774437510817346,0.0015849625007211565,0.1320802083934297
111.py,11,6,5,3,3,100.0,1,2,3,1,2,3,3,4.754887502163469,0.5,2.3774437510817346,0.0015849625007211565,0.1320802083934297
73.py,2,3,2,0,2,79.65883099752473,3,5,8,3,5,8,8,24.0,1.5,36.0,0.008,2.0
85.py,2,2,2,0,4,80.77781576413629,4,8,12,5,10,15,12,53.77443751081735,2.5,134.43609377704337,0.017924812503605784,7.468671876502409
92.py,4,4,4,0,4,73.29635806752523,3,8,11,7,14,21,11,72.64806399138325,2.625,190.70116797738103,0.024216021330461083,10.594509332076724
159.py,4,4,4,0,1,78.39554672677042,2,4,6,2,4,6,6,15.509775004326936,1.0,15.509775004326936,0.005169925001442312,0.861654166907052
44.py,5,5,5,0,2,73.5864370401145,4,4,8,4,8,12,8,36.0,4.0,144.0,0.012,8.0
158.py,3,4,3,0,1,100.0,0,0,0,0,0,0,0,0,0,0,0.0,0.0
58.py,2,2,2,0,1,88.5574946685516,1,2,3,1,2,3,3,4.754887502163469,0.5,2.3774437510817346,0.0015849625007211565,0.1320802083934297
51.py,3,3,3,0,3,84.44724042799471,1,2,3,1,2,3,3,4.754887502163469,0.5,2.3774437510817346,0.0015849625007211565,0.1320802083934297
46.py,9,7,7,0,3,69.152428164529,2,9,11,5,10,15,11,51.89147427955947,1.1111111111111112,57.65719364395497,0.01729715809318649,3.203177424664165
37.py,4,7,4,0,6,69.81541769850197,3,7,10,4,7,11,10,36.541209043760986,1.5,54.81181356564148,0.012180403014586996,3.0451007536467487
57.py,2,2,2,0,4,79.49312372420772,5,10,15,7,14,21,15,82.0447025077789,3.5,287.15645877722613,0.02734823416925963,15.953136598734785
127.py,12,11,11,0,4,63.74001915893738,6,10,16,6,12,18,16,72.0,3.6,259.2,0.024,14.399999999999999
132.py,13,13,13,0,7,60.35060442971517,5,9,14,10,20,30,14,114.22064766172811,5.555555555555555,634.5591536762672,0.038073549220576035,35.25328631534818
105.py,13,5,13,0,2,77.48167446491142,1,3,4,2,3,5,4,10.0,0.5,5.0,0.0033333333333333335,0.2777777777777778
91.py,7,4,5,0,3,100.0,0,0,0,0,0,0,0,0,0,0,0.0,0.0
33.py,4,6,4,0,1,100.0,0,0,0,0,0,0,0,0,0,0,0.0,0.0
109.py,11,10,9,0,2,68.25277285127902,3,5,8,3,5,8,8,24.0,1.5,36.0,0.008,2.0
38.py,6,6,6,0,4,68.55502039697015,5,10,15,9,16,25,15,97.67226489021297,4.0,390.6890595608519,0.03255742163007099,21.70494775338066
25.py,15,13,13,0,4,62.72225226067195,6,4,10,6,12,18,10,59.794705707972525,9.0,538.1523513717527,0.019931568569324175,29.897352853986263
19.py,18,6,16,0,1,100.0,0,0,0,0,0,0,0,0,0,0,0.0,0.0
31.py,13,13,13,0,8,58.262699750084565,6,17,23,16,32,48,23,217.13097389073664,5.647058823529412,1226.1513819712188,0.07237699129691222,68.11952122062327
88.py,4,4,4,0,2,75.26711952791365,4,7,11,5,7,12,11,41.51317942364757,2.0,83.02635884729514,0.01383772647454919,4.612575491516397
3.py,6,4,4,0,2,81.85633424453339,1,2,3,1,2,3,3,4.754887502163469,0.5,2.3774437510817346,0.0015849625007211565,0.1320802083934297
34.py,5,3,3,0,1,100.0,0,0,0,0,0,0,0,0,0,0,0.0,0.0
122.py,2,3,2,0,3,80.38318768502602,2,4,6,3,4,7,6,18.094737505048094,1.0,18.094737505048094,0.006031579168349364,1.0052631947248942
138.py,5,5,5,0,4,71.44632986537584,4,9,13,6,12,18,13,66.60791492653966,2.6666666666666665,177.62110647077242,0.022202638308846556,9.867839248376246
153.py,4,4,4,0,1,77.26975036905904,2,5,7,3,5,8,7,22.458839376460833,1.0,22.458839376460833,0.007486279792153611,1.2477132986922685
112.py,3,5,3,0,2,77.02781257964013,2,3,5,2,3,5,5,11.60964047443681,1.0,11.60964047443681,0.0038698801581456034,0.6449800263576005
14.py,5,4,3,0,2,81.85633424453339,1,2,3,1,2,3,3,4.754887502163469,0.5,2.3774437510817346,0.0015849625007211565,0.1320802083934297
100.py,2,2,2,0,2,81.58852089363933,3,5,8,5,10,15,8,45.0,3.0,135.0,0.015,7.5
117.py,3,3,3,0,4,80.71744706227851,2,4,6,2,4,6,6,15.509775004326936,1.0,15.509775004326936,0.005169925001442312,0.861654166907052
94.py,16,15,15,0,1,60.48049495594616,5,9,14,8,16,24,14,91.37651812938249,4.444444444444445,406.1178583528111,0.03045883937646083,22.56210324182284
125.py,7,7,7,0,6,67.75297764118154,5,11,16,6,12,18,16,72.0,2.727272727272727,196.36363636363635,0.024,10.909090909090908
124.py,16,14,14,0,11,58.1176039536435,6,17,23,11,24,35,23,158.32466846199546,4.235294117647059,670.5515370155102,0.05277488948733182,37.252863167528346
52.py,2,2,2,0,2,88.42299174457497,1,2,3,1,2,3,3,4.754887502163469,0.5,2.3774437510817346,0.0015849625007211565,0.1320802083934297
