File Name,LOC,LLOC,SLOC,Comments,Cyclomatic Complexity,Maintainability Index,h1,h2,h,N1,N2,N,Vocabulary,Volume,Difficulty,Effort,Bugs,Time
147.py,14,11,11,2,6,83.99438680399199,5,15,20,11,22,33,20,142.62362713128297,3.6666666666666665,522.9532994813709,0.04754120904376099,29.05296108229838
115.py,27,19,19,4,2,87.2962456371915,2,4,6,2,4,6,6,15.509775004326936,1.0,15.509775004326936,0.005169925001442312,0.861654166907052
128.py,21,16,16,4,5,84.05209261356313,6,9,15,10,17,27,15,105.48604608143,5.666666666666667,597.7542611281034,0.03516201536047667,33.20857006267241
43.py,23,8,7,0,3,75.60345168368548,2,3,5,2,3,5,5,11.60964047443681,1.0,11.60964047443681,0.0038698801581456034,0.6449800263576005
82.py,17,13,13,5,1,91.40618068296047,5,8,13,5,10,15,13,55.506595772116384,3.125,173.4581117878637,0.01850219859070546,9.636561765992427
84.py,12,10,9,4,2,95.56906140447468,4,5,9,4,8,12,9,38.03910001730775,3.2,121.72512005538482,0.012679700005769252,6.762506669743601
60.py,19,8,7,6,1,79.28057141841599,3,5,8,3,6,9,8,27.0,1.8,48.6,0.009,2.7
22.py,12,4,3,0,3,100.0,0,0,0,0,0,0,0,0,0,0,0.0,0.0
23.py,8,3,2,0,1,100.0,0,0,0,0,0,0,0,0,0,0,0.0,0.0
40.py,32,13,12,6,5,73.40828607603106,3,11,14,7,12,19,14,72.33974351909447,1.6363636363636365,118.37412575851823,0.024113247839698156,6.57634031991768
12.py,9,6,6,0,5,74.89704695387283,2,3,5,2,3,5,5,11.60964047443681,1.0,11.60964047443681,0.0038698801581456034,0.6449800263576005
111.py,18,14,14,0,6,62.860827077840575,3,8,11,4,8,12,11,41.51317942364757,1.5,62.26976913547136,0.01383772647454919,3.4594316186372978
112.py,10,8,7,4,3,99.4717377659546,3,5,8,3,5,8,8,24.0,1.5,36.0,0.008,2.0
79.py,8,6,5,3,1,100.0,1,3,4,2,4,6,4,12.0,0.6666666666666666,8.0,0.004,0.4444444444444444
31.py,23,20,20,8,8,82.43636863151448,6,17,23,16,32,48,23,217.13097389073664,5.647058823529412,1226.1513819712188,0.07237699129691222,68.11952122062327
7.py,5,3,3,0,3,84.44724042799471,1,2,3,1,2,3,3,4.754887502163469,0.5,2.3774437510817346,0.0015849625007211565,0.1320802083934297
102.py,11,8,8,3,4,94.91962491601394,6,9,15,6,11,17,15,66.41714012534482,3.6666666666666665,243.52951379293097,0.02213904670844827,13.52941743294061
65.py,6,8,6,0,2,69.13377107883912,3,5,8,5,7,12,8,36.0,2.1,75.60000000000001,0.012,4.2
69.py,21,15,15,4,6,86.59260682606286,6,7,13,6,11,17,13,62.907475208398566,4.714285714285714,296.5638116967361,0.02096915840279952,16.47576731648534
141.py,16,11,11,0,7,63.76630280388749,5,10,15,6,10,16,15,62.5102495297363,2.5,156.27562382434076,0.020836749843245433,8.681979101352264
44.py,15,10,10,4,2,96.60217164455938,3,3,6,3,6,9,6,23.264662506490403,3.0,69.79398751947122,0.007754887502163467,3.877443751081734
107.py,16,13,12,0,5,61.90862874635699,4,11,15,7,13,20,15,78.13781191217038,2.3636363636363638,184.68937361058454,0.026045937304056792,10.260520756143585
81.py,35,29,29,2,13,66.78985564001722,2,12,14,11,22,33,14,125.64271242790092,1.8333333333333333,230.344972784485,0.04188090414263364,12.796942932471389
103.py,13,9,9,5,2,95.75505247734337,5,6,11,6,11,17,11,58.81033751683406,4.583333333333333,269.54738028548945,0.019603445838944685,14.97485446030497
28.py,6,3,3,0,1,100.0,0,0,0,0,0,0,0,0,0,0,0.0,0.0
73.py,14,10,10,4,3,93.91978234104299,4,8,12,5,10,15,12,53.77443751081735,2.5,134.43609377704337,0.017924812503605784,7.468671876502409
3.py,16,10,10,3,3,94.82600726968178,3,4,7,3,5,8,7,22.458839376460833,1.875,42.11032383086406,0.007486279792153611,2.3394624350480036
59.py,13,10,10,3,3,92.54508092084679,5,4,9,5,10,15,9,47.548875021634686,6.25,297.1804688852168,0.01584962500721156,16.51002604917871
136.py,14,9,9,4,7,96.264066890538,3,4,7,4,8,12,7,33.68825906469125,3.0,101.06477719407376,0.011229419688230418,5.614709844115208
140.py,11,8,8,7,1,100.0,0,0,0,0,0,0,0,0,0,0,0.0,0.0
146.py,19,14,14,3,4,82.44384190433851,9,23,32,14,24,38,32,190.0,4.695652173913044,892.1739130434784,0.06333333333333334,49.56521739130435
57.py,11,7,7,4,4,96.45028246749935,6,11,17,8,15,23,17,94.01164534875782,4.090909090909091,384.59309460855474,0.031337215116252606,21.366283033808596
94.py,18,15,15,0,4,60.1500746909023,7,12,19,7,14,21,19,89.20647778231529,4.083333333333333,364.2597842777874,0.029735492594105097,20.2366546820993
34.py,2,2,2,0,1,100.0,0,0,0,0,0,0,0,0,0,0,0.0,0.0
123.py,20,10,10,6,5,93.18939434174189,6,6,12,8,16,24,12,86.03910001730776,8.0,688.3128001384621,0.028679700005769252,38.23960000769234
11.py,9,8,8,0,3,70.07591638631968,2,5,7,3,6,9,7,25.26619429851844,1.2,30.319433158222125,0.008422064766172813,1.6844129532345624
85.py,10,7,7,1,3,91.60114355223193,3,6,9,3,6,9,9,28.529325012980813,1.5,42.793987519471216,0.009509775004326938,2.377443751081734
64.py,19,13,13,5,5,90.01125050549423,6,11,17,6,12,18,17,73.57433114250613,3.272727272727273,240.78872010274733,0.02452477704750204,13.377151116819297
91.py,17,11,12,3,6,90.19480534053584,4,8,12,4,8,12,12,43.01955000865388,2.0,86.03910001730776,0.014339850002884626,4.779950000961542
8.py,20,10,9,0,3,98.60902421263637,2,3,5,2,3,5,5,11.60964047443681,1.0,11.60964047443681,0.0038698801581456034,0.6449800263576005
98.py,15,10,10,4,3,97.70066203178888,2,4,6,2,4,6,6,15.509775004326936,1.0,15.509775004326936,0.005169925001442312,0.861654166907052
113.py,12,8,9,1,4,90.05319959619166,2,4,6,2,4,6,6,15.509775004326936,1.0,15.509775004326936,0.005169925001442312,0.861654166907052
155.py,14,11,11,3,3,90.78910767461211,4,8,12,5,9,14,12,50.18947501009619,2.25,112.92631877271643,0.016729825003365395,6.273684376262024
158.py,19,14,14,4,4,93.06233402614706,2,2,4,2,4,6,4,12.0,2.0,24.0,0.004,1.3333333333333333
139.py,13,9,9,2,3,92.11452568800708,2,6,8,4,8,12,8,36.0,1.3333333333333333,48.0,0.012,2.6666666666666665
156.py,22,14,16,4,6,85.80945746859028,7,10,17,7,14,21,17,85.83671966625714,4.9,420.59992636466,0.02861223988875238,23.366662575814445
86.py,13,9,9,4,2,100.0,0,0,0,0,0,0,0,0,0,0,0.0,0.0
124.py,50,33,33,13,17,74.01039613531871,8,41,49,33,52,85,49,477.2503367497927,5.073170731707317,2421.1724400965095,0.15908344558326423,134.50958000536164
70.py,14,11,11,4,3,100.0,0,0,0,0,0,0,0,0,0,0,0.0,0.0
105.py,19,11,10,6,4,96.39809590212832,2,4,6,4,5,9,6,23.264662506490403,1.25,29.080828133113002,0.007754887502163467,1.6156015629507223
137.py,21,18,18,5,8,86.4295677600723,3,6,9,4,8,12,9,38.03910001730775,2.0,76.0782000346155,0.012679700005769252,4.226566668589751
133.py,13,10,10,6,2,95.13554806608076,4,9,13,5,9,14,13,51.80615605397529,2.0,103.61231210795059,0.01726871868465843,5.75623956155281
110.py,12,12,12,0,6,62.51105609634401,5,7,12,7,14,21,12,75.28421251514429,5.0,376.42106257572146,0.025094737505048096,20.912281254206746
77.py,28,12,11,7,2,77.12583887906432,4,6,10,4,7,11,10,36.541209043760986,2.3333333333333335,85.26282110210897,0.012180403014586996,4.736823394561609
14.py,11,6,5,2,2,100.0,1,2,3,1,2,3,3,4.754887502163469,0.5,2.3774437510817346,0.0015849625007211565,0.1320802083934297
97.py,9,6,6,5,1,100.0,2,4,6,4,5,9,6,23.264662506490403,1.25,29.080828133113002,0.007754887502163467,1.6156015629507223
131.py,16,12,12,4,4,91.8035859970402,4,7,11,4,8,12,11,41.51317942364757,2.2857142857142856,94.88726725405158,0.01383772647454919,5.27151484744731
55.py,11,8,8,4,2,100.0,1,2,3,1,2,3,3,4.754887502163469,0.5,2.3774437510817346,0.0015849625007211565,0.1320802083934297
49.py,2,2,2,0,1,100.0,0,0,0,0,0,0,0,0,0,0,0.0,0.0
53.py,7,4,4,3,1,100.0,1,2,3,1,2,3,3,4.754887502163469,0.5,2.3774437510817346,0.0015849625007211565,0.1320802083934297
121.py,8,5,5,4,4,100.0,3,6,9,4,8,12,9,38.03910001730775,2.0,76.0782000346155,0.012679700005769252,4.226566668589751
48.py,9,7,6,6,1,99.61699544841088,2,3,5,2,3,5,5,11.60964047443681,1.0,11.60964047443681,0.0038698801581456034,0.6449800263576005
9.py,7,7,6,0,2,76.55471099040834,1,2,3,1,2,3,3,4.754887502163469,0.5,2.3774437510817346,0.0015849625007211565,0.1320802083934297
54.py,2,2,2,0,1,88.5574946685516,1,2,3,1,2,3,3,4.754887502163469,0.5,2.3774437510817346,0.0015849625007211565,0.1320802083934297
160.py,28,22,22,2,9,69.47652206633016,7,23,30,19,38,57,30,279.69276394968557,5.782608695652174,1617.3538089264425,0.09323092131656185,89.85298938480236
27.py,2,2,2,0,1,100.0,0,0,0,0,0,0,0,0,0,0,0.0,0.0
51.py,3,3,3,0,3,84.44724042799471,1,2,3,1,2,3,3,4.754887502163469,0.5,2.3774437510817346,0.0015849625007211565,0.1320802083934297
159.py,8,8,8,0,2,69.33559663383471,3,4,7,4,8,12,7,33.68825906469125,3.0,101.06477719407376,0.011229419688230418,5.614709844115208
37.py,12,11,8,3,2,100.0,1,2,3,1,2,3,3,4.754887502163469,0.5,2.3774437510817346,0.0015849625007211565,0.1320802083934297
92.py,12,9,9,5,6,92.86545191485068,5,14,19,10,20,30,19,127.43782540330756,3.5714285714285716,455.13509072609844,0.042479275134435855,25.28528281811658
72.py,12,9,9,5,3,96.94432380514502,4,7,11,4,7,11,11,38.053747805010275,2.0,76.10749561002055,0.012684582601670092,4.228194200556697
33.py,8,5,5,3,5,100.0,3,5,8,4,8,12,8,36.0,2.4,86.39999999999999,0.012,4.8
19.py,19,10,10,2,1,100.0,0,0,0,0,0,0,0,0,0,0,0.0,0.0
100.py,12,9,9,2,3,89.77466205999254,4,9,13,7,14,21,13,77.70923408096293,3.111111111111111,241.762061585218,0.025903078026987644,13.431225643623222
126.py,19,15,15,9,4,93.0069868187939,3,5,8,3,6,9,8,27.0,1.8,48.6,0.009,2.7
52.py,8,3,2,0,2,71.9331936183837,1,2,3,1,2,3,3,4.754887502163469,0.5,2.3774437510817346,0.0015849625007211565,0.1320802083934297
50.py,12,6,4,0,6,84.89235923428336,3,16,19,8,16,24,19,101.95026032264605,1.5,152.92539048396907,0.03398342010754868,8.49585502688717
119.py,14,14,14,0,6,62.61557094352466,3,5,8,5,10,15,8,45.0,3.0,135.0,0.015,7.5
108.py,21,16,16,4,3,85.6325695392166,5,9,14,7,11,18,14,68.53238859703687,3.0555555555555554,209.4045207131682,0.022844129532345624,11.633584484064901
163.py,18,12,12,4,3,92.06142604143426,4,6,10,4,8,12,10,39.863137138648355,2.6666666666666665,106.3016990363956,0.013287712379549451,5.905649946466422
38.py,14,12,12,0,8,59.24392455634642,5,19,24,16,30,46,24,210.90827503317323,3.9473684210526314,832.5326646046311,0.07030275834439108,46.251814700257285
5.py,16,10,10,4,2,100.0,0,0,0,0,0,0,0,0,0,0,0.0,0.0
142.py,15,11,11,4,5,88.43073841755873,7,17,24,15,26,41,24,187.98346252956745,5.352941176470588,1006.2644170700374,0.06266115417652249,55.90357872611319
4.py,19,7,6,2,2,84.42591545022593,2,6,8,3,6,9,8,27.0,1.0,27.0,0.009,1.5
58.py,9,3,2,0,1,72.06769654236032,1,2,3,1,2,3,3,4.754887502163469,0.5,2.3774437510817346,0.0015849625007211565,0.1320802083934297
93.py,19,14,14,3,4,86.51391689099874,2,8,10,5,10,15,10,49.82892142331044,1.25,62.28615177913805,0.016609640474436815,3.4603417655076694
29.py,6,3,3,0,3,100.0,0,0,0,0,0,0,0,0,0,0,0.0,0.0
127.py,31,22,22,4,7,77.38264303157148,8,15,23,12,20,32,23,144.75398259382442,5.333333333333333,772.0212405003969,0.048251327531274806,42.89006891668871
104.py,12,8,8,3,4,99.34261928582906,2,4,6,2,4,6,6,15.509775004326936,1.0,15.509775004326936,0.005169925001442312,0.861654166907052
99.py,15,12,12,5,3,92.38554704456723,5,7,12,5,10,15,12,53.77443751081735,3.5714285714285716,192.0515625386334,0.017924812503605784,10.6695312521463
68.py,10,7,7,0,4,71.36279278800855,3,5,8,3,5,8,8,24.0,1.5,36.0,0.008,2.0
135.py,13,8,8,3,3,97.38292854109056,3,4,7,4,7,11,7,30.880904142633646,2.625,81.06237337441333,0.010293634714211216,4.503465187467407
71.py,12,9,9,3,4,88.92273822659394,8,21,29,18,36,54,29,262.33097373688895,6.857142857142857,1798.8409627672384,0.08744365791229632,99.93560904262435
89.py,23,20,20,6,7,83.45398009203234,4,10,14,8,16,24,14,91.37651812938249,3.2,292.404858014024,0.03045883937646083,16.244714334112444
20.py,23,13,13,3,3,87.9425765030228,3,7,10,5,10,15,10,49.82892142331044,2.142857142857143,106.77626019280808,0.016609640474436815,5.932014455156004
87.py,23,12,15,4,4,94.11426601946309,2,3,5,2,3,5,5,11.60964047443681,1.0,11.60964047443681,0.0038698801581456034,0.6449800263576005
25.py,11,10,10,0,3,65.8967395002637,5,5,10,5,10,15,10,49.82892142331044,5.0,249.1446071165522,0.016609640474436815,13.841367062030677
117.py,20,16,16,6,3,91.05712986496222,3,6,9,3,6,9,9,28.529325012980813,1.5,42.793987519471216,0.009509775004326938,2.377443751081734
148.py,22,14,14,4,4,88.50126026044049,4,8,12,5,10,15,12,53.77443751081735,2.5,134.43609377704337,0.017924812503605784,7.468671876502409
62.py,13,6,5,0,2,92.55890207101166,1,2,3,1,2,3,3,4.754887502163469,0.5,2.3774437510817346,0.0015849625007211565,0.1320802083934297
134.py,16,11,11,7,5,93.43796626058351,3,9,12,6,10,16,12,57.359400011538504,1.6666666666666667,95.59900001923084,0.01911980000384617,5.311055556623936
42.py,2,2,2,0,2,88.42299174457497,1,2,3,1,2,3,3,4.754887502163469,0.5,2.3774437510817346,0.0015849625007211565,0.1320802083934297
138.py,14,11,11,4,4,92.47953218553636,4,7,11,5,10,15,11,51.89147427955947,2.857142857142857,148.26135508445563,0.01729715809318649,8.236741949136423
24.py,9,5,5,2,3,100.0,4,5,9,4,7,11,9,34.86917501586544,2.8,97.63369004442322,0.011623058338621813,5.424093891356845
144.py,13,8,8,4,1,99.21993498486088,2,6,8,3,6,9,8,27.0,1.0,27.0,0.009,1.5
120.py,17,13,12,4,1,91.86614141909885,1,5,6,7,7,14,6,36.18947501009619,0.7,25.33263250706733,0.012063158336698729,1.4073684726148517
114.py,17,11,11,3,3,91.89662296024306,3,6,9,5,6,11,9,34.86917501586544,1.5,52.303762523798156,0.011623058338621813,2.905764584655453
0.py,21,10,9,3,4,91.36784652090697,3,6,9,3,6,9,9,28.529325012980813,1.5,42.793987519471216,0.009509775004326938,2.377443751081734
17.py,15,8,7,1,2,100.0,0,0,0,0,0,0,0,0,0,0,0.0,0.0
32.py,31,19,16,0,7,85.04777557692316,6,15,21,12,20,32,21,140.55415752892034,4.0,562.2166301156814,0.04685138584297345,31.234257228648964
101.py,10,5,5,3,1,100.0,0,0,0,0,0,0,0,0,0,0,0.0,0.0
41.py,15,3,2,1,1,100.0,0,0,0,0,0,0,0,0,0,0,0.0,0.0
35.py,3,3,2,0,1,100.0,0,0,0,0,0,0,0,0,0,0,0.0,0.0
90.py,14,10,10,5,2,100.0,1,2,3,1,2,3,3,4.754887502163469,0.5,2.3774437510817346,0.0015849625007211565,0.1320802083934297
18.py,14,11,11,4,5,90.67308513912852,5,12,17,8,14,22,17,89.92418250750748,2.9166666666666665,262.2788656468968,0.029974727502502494,14.571048091494267
116.py,2,3,2,0,1,100.0,0,0,0,0,0,0,0,0,0,0,0.0,0.0
66.py,15,12,12,7,3,100.0,1,2,3,1,2,3,3,4.754887502163469,0.5,2.3774437510817346,0.0015849625007211565,0.1320802083934297
36.py,12,9,9,4,5,93.11321802164773,6,14,20,8,16,24,20,103.72627427729671,3.4285714285714284,355.63294037930297,0.0345754247590989,19.757385576627943
47.py,17,12,12,3,2,87.15837892569651,7,10,17,9,17,26,17,106.27403387250884,5.95,632.3305015414276,0.03542467795750295,35.129472307857085
16.py,19,8,8,8,2,100.0,0,0,0,0,0,0,0,0,0,0,0.0,0.0
63.py,24,20,20,4,5,81.88734265984701,2,8,10,6,12,18,10,59.794705707972525,1.5,89.69205856195879,0.019931568569324175,4.9828921423310435
26.py,13,8,8,2,3,100.0,1,2,3,1,2,3,3,4.754887502163469,0.5,2.3774437510817346,0.0015849625007211565,0.1320802083934297
150.py,25,20,20,3,10,75.0735393450701,6,17,23,16,32,48,23,217.13097389073664,5.647058823529412,1226.1513819712188,0.07237699129691222,68.11952122062327
13.py,16,7,6,3,2,89.70699843941705,1,2,3,1,2,3,3,4.754887502163469,0.5,2.3774437510817346,0.0015849625007211565,0.1320802083934297
161.py,24,19,18,4,5,84.35569953711759,3,6,9,5,8,13,9,41.20902501875006,2.0,82.41805003750012,0.013736341672916687,4.578780557638896
109.py,18,13,12,4,4,91.31105341480239,4,5,9,5,7,12,9,38.03910001730775,2.8,106.5094800484617,0.012679700005769252,5.91719333602565
151.py,21,7,6,5,5,66.1339265044352,7,10,17,9,16,25,17,102.1865710312585,5.6,572.2447977750476,0.03406219034375283,31.79137765416931
130.py,21,16,16,3,6,80.35826683504682,5,12,17,13,26,39,17,159.41105080876326,5.416666666666667,863.4765252141344,0.05313701693625442,47.97091806745191
67.py,23,15,15,7,5,91.86473145346368,2,5,7,4,8,12,7,33.68825906469125,1.6,53.901214503506004,0.011229419688230418,2.9945119168614447
45.py,17,4,3,2,1,61.22514308338081,1,4,5,2,4,6,5,13.931568569324174,0.5,6.965784284662087,0.004643856189774725,0.3869880158145604
88.py,10,7,7,5,1,99.1297022473245,4,7,11,4,7,11,11,38.053747805010275,2.0,76.10749561002055,0.012684582601670092,4.228194200556697
152.py,9,4,4,3,3,100.0,3,5,8,4,6,10,8,30.0,1.8,54.0,0.01,3.0
15.py,3,2,2,0,2,88.42299174457497,1,2,3,1,2,3,3,4.754887502163469,0.5,2.3774437510817346,0.0015849625007211565,0.1320802083934297
125.py,17,14,14,4,6,87.3447028916524,5,11,16,6,12,18,16,72.0,2.727272727272727,196.36363636363635,0.024,10.909090909090908
78.py,24,19,19,6,7,84.55626898131162,6,12,18,7,14,21,18,87.56842503028855,3.5,306.4894876060099,0.029189475010096184,17.02719375588944
145.py,7,5,4,2,1,100.0,0,0,0,0,0,0,0,0,0,0,0.0,0.0
157.py,10,7,7,3,4,93.1734973907669,4,19,23,16,33,49,23,221.65453584679364,3.473684210526316,769.9578613625464,0.07388484528226455,42.77543674236369
6.py,18,15,15,1,5,76.83675913586451,3,6,9,5,10,15,9,47.548875021634686,2.5,118.87218755408671,0.01584962500721156,6.604010419671484
1.py,17,14,14,0,6,62.657831530228236,2,7,9,5,9,14,9,44.37895002019238,1.2857142857142858,57.05865002596163,0.014792983340064125,3.169925001442313
46.py,23,17,17,4,6,83.3935958398197,2,11,13,8,16,24,13,88.81055323538621,1.4545454545454546,129.17898652419814,0.029603517745128736,7.1766103624554525
162.py,14,7,6,0,2,100.0,0,0,0,0,0,0,0,0,0,0,0.0,0.0
96.py,24,19,19,7,3,87.30617742335619,5,8,13,5,10,15,13,55.506595772116384,3.125,173.4581117878637,0.01850219859070546,9.636561765992427
153.py,19,12,12,2,7,89.06901896006234,2,4,6,2,4,6,6,15.509775004326936,1.0,15.509775004326936,0.005169925001442312,0.861654166907052
122.py,16,11,11,2,3,88.68137575162551,3,6,9,4,7,11,9,34.86917501586544,1.75,61.021056277764515,0.011623058338621813,3.3900586820980285
30.py,2,2,2,0,3,88.28848882059837,1,2,3,1,2,3,3,4.754887502163469,0.5,2.3774437510817346,0.0015849625007211565,0.1320802083934297
95.py,20,19,15,6,6,91.21643223296267,2,4,6,2,4,6,6,15.509775004326936,1.0,15.509775004326936,0.005169925001442312,0.861654166907052
83.py,11,8,8,4,4,95.08838592203487,6,10,16,8,15,23,16,92.0,4.5,414.0,0.030666666666666665,23.0
80.py,18,13,13,7,6,89.20268059069292,5,15,20,10,21,31,20,133.97977094150824,3.5,468.9291982952788,0.04465992364716941,26.05162212751549
76.py,14,11,11,7,2,95.0904546931744,3,6,9,4,8,12,9,38.03910001730775,2.0,76.0782000346155,0.012679700005769252,4.226566668589751
39.py,30,22,22,6,10,80.23946774063812,6,14,20,12,21,33,20,142.62362713128297,4.5,641.8063220907734,0.04754120904376099,35.65590678282074
129.py,40,28,28,3,4,70.50845094155605,7,18,25,13,25,38,25,176.46653521143952,4.861111111111111,857.8234350556087,0.05882217840381317,47.65685750308937
154.py,15,13,12,8,3,95.98614074515322,2,4,6,2,4,6,6,15.509775004326936,1.0,15.509775004326936,0.005169925001442312,0.861654166907052
21.py,15,7,7,2,2,97.63383630672524,2,5,7,3,6,9,7,25.26619429851844,1.2,30.319433158222125,0.008422064766172813,1.6844129532345624
2.py,7,3,3,2,1,100.0,1,2,3,1,2,3,3,4.754887502163469,0.5,2.3774437510817346,0.0015849625007211565,0.1320802083934297
118.py,25,18,18,5,6,84.59388497583362,6,10,16,7,12,19,16,76.0,3.6,273.6,0.025333333333333333,15.200000000000001
143.py,27,21,21,3,11,74.07993075620249,6,17,23,16,32,48,23,217.13097389073664,5.647058823529412,1226.1513819712188,0.07237699129691222,68.11952122062327
106.py,18,15,15,2,5,80.50722797013972,4,9,13,7,14,21,13,77.70923408096293,3.111111111111111,241.762061585218,0.025903078026987644,13.431225643623222
75.py,19,14,14,2,8,79.75393872312068,6,17,23,10,20,30,23,135.7068586817104,3.5294117647058822,478.9653835825073,0.04523561956057014,26.60918797680596
74.py,19,14,14,6,3,95.60936009600898,2,2,4,2,4,6,4,12.0,2.0,24.0,0.004,1.3333333333333333
56.py,18,14,14,5,5,91.33158986628631,2,6,8,4,7,11,8,33.0,1.1666666666666667,38.5,0.011,2.138888888888889
132.py,18,14,14,7,6,90.41325799535308,4,10,14,6,12,18,14,68.53238859703687,2.4,164.4777326328885,0.022844129532345624,9.13765181293825
10.py,32,17,13,4,2,83.99961816409545,4,9,13,6,9,15,13,55.506595772116384,2.0,111.01319154423277,0.01850219859070546,6.167399530235154
61.py,19,15,15,5,6,88.25302012816216,3,9,12,6,11,17,12,60.94436251225966,1.8333333333333333,111.73133127247604,0.020314787504086555,6.2072961818042245
149.py,9,7,6,3,3,100.0,2,4,6,2,4,6,6,15.509775004326936,1.0,15.509775004326936,0.005169925001442312,0.861654166907052
