File Name,LOC,LLOC,SLOC,Comments,Cyclomatic Complexity,Maintainability Index,h1,h2,h,N1,N2,N,Vocabulary,Volume,Difficulty,Effort,Bugs,Time
147.py,7,7,7,0,2,67.56626620925594,4,10,14,8,16,24,14,91.37651812938249,3.2,292.404858014024,0.03045883937646083,16.244714334112444
115.py,4,3,3,0,2,79.30066036278018,3,5,8,3,6,9,8,27.0,1.8,48.6,0.009,2.7
128.py,8,8,8,0,6,67.17923742492133,5,7,12,6,10,16,12,57.359400011538504,3.5714285714285716,204.85500004120897,0.01911980000384617,11.38083333562272
43.py,9,6,6,3,3,100.0,2,3,5,2,3,5,5,11.60964047443681,1.0,11.60964047443681,0.0038698801581456034,0.6449800263576005
82.py,11,9,9,0,4,67.31561689475312,4,7,11,4,8,12,11,41.51317942364757,2.2857142857142856,94.88726725405158,0.01383772647454919,5.27151484744731
84.py,4,6,4,0,1,100.0,0,0,0,0,0,0,0,0,0,0,0.0,0.0
60.py,2,2,2,0,1,88.5574946685516,1,2,3,1,2,3,3,4.754887502163469,0.5,2.3774437510817346,0.0015849625007211565,0.1320802083934297
22.py,2,2,2,0,3,88.28848882059837,1,2,3,1,2,3,3,4.754887502163469,0.5,2.3774437510817346,0.0015849625007211565,0.1320802083934297
23.py,2,2,2,0,1,100.0,0,0,0,0,0,0,0,0,0,0,0.0,0.0
40.py,16,16,16,0,7,56.83615327771027,6,17,23,14,28,42,23,189.98960215439456,4.9411764705882355,938.7721518217144,0.06332986738479819,52.15400843453969
12.py,4,4,4,0,2,84.48986316429594,1,1,2,1,1,2,2,2.0,0.5,1.0,0.0006666666666666666,0.05555555555555555
111.py,5,7,5,0,5,76.15120221847852,1,2,3,1,2,3,3,4.754887502163469,0.5,2.3774437510817346,0.0015849625007211565,0.1320802083934297
112.py,3,4,3,0,3,76.79891896611021,3,5,8,3,5,8,8,24.0,1.5,36.0,0.008,2.0
79.py,2,3,2,0,1,81.90114990916902,1,3,4,2,4,6,4,12.0,0.6666666666666666,8.0,0.004,0.4444444444444444
31.py,12,12,12,0,6,62.00858698708201,4,9,13,8,16,24,13,88.81055323538621,3.5555555555555554,315.7708559480398,0.029603517745128736,17.542825330446657
7.py,2,2,2,0,3,88.28848882059837,1,2,3,1,2,3,3,4.754887502163469,0.5,2.3774437510817346,0.0015849625007211565,0.1320802083934297
102.py,7,7,7,0,4,68.3551068840465,5,7,12,7,11,18,12,64.52932501298082,3.9285714285714284,253.50806255099607,0.02150977500432694,14.083781252833115
65.py,8,10,8,0,2,67.01977954007292,3,5,8,5,7,12,8,36.0,2.1,75.60000000000001,0.012,4.2
69.py,4,5,4,0,5,76.6243038077103,2,3,5,2,3,5,5,11.60964047443681,1.0,11.60964047443681,0.0038698801581456034,0.6449800263576005
141.py,23,12,12,5,7,90.72979319119696,5,12,17,7,12,19,17,77.66179398375645,2.5,194.15448495939114,0.02588726466125215,10.78636027552173
44.py,5,5,5,0,4,75.15831043359547,2,5,7,2,5,7,7,19.651484454403228,1.0,19.651484454403228,0.00655049481813441,1.0917491363557348
107.py,16,13,12,1,4,79.0334547825154,4,9,13,6,11,17,13,62.907475208398566,2.4444444444444446,153.7738282871965,0.02096915840279952,8.542990460399805
81.py,30,30,30,0,14,50.85382836650843,2,13,15,12,24,36,15,140.64806144190666,1.8461538461538463,259.65795958505845,0.04688268714730222,14.425442199169915
103.py,6,6,6,0,2,71.9562338891291,4,5,9,4,7,11,9,34.86917501586544,2.8,97.63369004442322,0.011623058338621813,5.424093891356845
28.py,2,2,2,0,1,100.0,0,0,0,0,0,0,0,0,0,0,0.0,0.0
73.py,5,3,3,1,2,100.0,4,7,11,4,7,11,11,38.053747805010275,2.0,76.10749561002055,0.012684582601670092,4.228194200556697
3.py,7,7,7,0,3,73.15124981438153,2,3,5,2,4,6,5,13.931568569324174,1.3333333333333333,18.575424759098897,0.004643856189774725,1.0319680421721609
59.py,12,12,12,0,4,63.62298122972582,5,4,9,6,12,18,9,57.058650025961626,7.5,427.9398751947122,0.019019550008653876,23.774437510817346
136.py,4,6,4,0,1,75.33449240912742,2,2,4,2,4,6,4,12.0,2.0,24.0,0.004,1.3333333333333333
140.py,5,5,5,0,1,100.0,0,0,0,0,0,0,0,0,0,0,0.0,0.0
146.py,2,2,2,0,4,80.68140703010677,4,9,13,5,10,15,13,55.506595772116384,2.2222222222222223,123.34799060470309,0.01850219859070546,6.852666144705727
57.py,8,8,8,0,6,66.16928064266546,4,10,14,7,14,21,14,79.95445336320968,2.8,223.8724694169871,0.026651484454403226,12.437359412054839
94.py,12,10,10,0,2,65.70310633921059,5,8,13,5,10,15,13,55.506595772116384,3.125,173.4581117878637,0.01850219859070546,9.636561765992427
34.py,2,2,2,0,1,100.0,0,0,0,0,0,0,0,0,0,0,0.0,0.0
123.py,8,8,8,0,4,66.52490160287137,6,7,13,7,14,21,13,77.70923408096293,6.0,466.2554044857776,0.025903078026987644,25.903078026987643
11.py,2,2,2,0,2,88.42299174457497,1,2,3,1,2,3,3,4.754887502163469,0.5,2.3774437510817346,0.0015849625007211565,0.1320802083934297
85.py,4,3,4,0,4,76.93656737153263,4,8,12,5,10,15,12,53.77443751081735,2.5,134.43609377704337,0.017924812503605784,7.468671876502409
64.py,5,5,5,0,4,75.8780464160744,2,4,6,2,4,6,6,15.509775004326936,1.0,15.509775004326936,0.005169925001442312,0.861654166907052
91.py,5,3,3,2,3,100.0,0,0,0,0,0,0,0,0,0,0,0.0,0.0
8.py,12,10,10,0,2,73.1756852057256,1,2,3,1,2,3,3,4.754887502163469,0.5,2.3774437510817346,0.0015849625007211565,0.1320802083934297
98.py,3,3,3,0,3,84.44724042799471,1,2,3,1,2,3,3,4.754887502163469,0.5,2.3774437510817346,0.0015849625007211565,0.1320802083934297
113.py,7,6,7,0,4,77.74608000397652,1,2,3,1,2,3,3,4.754887502163469,0.5,2.3774437510817346,0.0015849625007211565,0.1320802083934297
155.py,10,10,10,0,3,66.5753046855467,3,7,10,4,8,12,10,39.863137138648355,1.7142857142857142,68.33680652339717,0.013287712379549451,3.796489251299843
158.py,10,10,10,0,3,73.041182281749,1,2,3,1,2,3,3,4.754887502163469,0.5,2.3774437510817346,0.0015849625007211565,0.1320802083934297
139.py,10,7,7,0,2,71.2736280012172,3,5,8,3,6,9,8,27.0,1.8,48.6,0.009,2.7
156.py,15,11,12,0,3,63.198519711900374,6,11,17,8,14,22,17,89.92418250750748,3.8181818181818183,343.34687866502856,0.029974727502502494,19.074826592501587
86.py,5,5,5,0,2,100.0,0,0,0,0,0,0,0,0,0,0,0.0,0.0
124.py,20,19,19,1,16,66.39873513888656,6,27,33,16,36,52,33,262.3084942066396,4.0,1049.2339768265583,0.08743616473554652,58.29077649036435
70.py,13,13,13,0,3,63.721155241121316,4,4,8,5,10,15,8,45.0,5.0,225.0,0.015,12.5
105.py,5,5,5,0,4,77.21266861695821,1,3,4,2,3,5,4,10.0,0.5,5.0,0.0033333333333333335,0.2777777777777778
137.py,10,9,9,0,3,71.22423816857055,2,2,4,2,4,6,4,12.0,2.0,24.0,0.004,1.3333333333333333
133.py,5,3,3,0,2,84.58174335197131,1,2,3,1,2,3,3,4.754887502163469,0.5,2.3774437510817346,0.0015849625007211565,0.1320802083934297
110.py,5,5,5,0,6,71.93655110795804,4,7,11,5,10,15,11,51.89147427955947,2.857142857142857,148.26135508445563,0.01729715809318649,8.236741949136423
77.py,3,3,3,0,1,78.25036867974562,3,7,10,4,8,12,10,39.863137138648355,1.7142857142857142,68.33680652339717,0.013287712379549451,3.796489251299843
14.py,2,3,2,0,2,84.58174335197131,1,2,3,1,2,3,3,4.754887502163469,0.5,2.3774437510817346,0.0015849625007211565,0.1320802083934297
97.py,6,6,6,0,1,73.0703313417108,2,5,7,3,6,9,7,25.26619429851844,1.2,30.319433158222125,0.008422064766172813,1.6844129532345624
131.py,7,7,7,0,4,69.81982754625282,3,7,10,4,8,12,10,39.863137138648355,1.7142857142857142,68.33680652339717,0.013287712379549451,3.796489251299843
55.py,12,12,12,0,5,63.90047679847302,4,6,10,5,10,15,10,49.82892142331044,3.3333333333333335,166.09640474436813,0.016609640474436815,9.227578041353786
49.py,2,2,2,0,1,100.0,0,0,0,0,0,0,0,0,0,0,0.0,0.0
53.py,2,2,2,0,1,88.5574946685516,1,2,3,1,2,3,3,4.754887502163469,0.5,2.3774437510817346,0.0015849625007211565,0.1320802083934297
121.py,2,2,2,0,4,80.77781576413629,3,9,12,5,10,15,12,53.77443751081735,1.6666666666666667,89.62406251802892,0.017924812503605784,4.9791145843349405
48.py,4,5,4,0,1,77.16231550361674,2,3,5,2,3,5,5,11.60964047443681,1.0,11.60964047443681,0.0038698801581456034,0.6449800263576005
9.py,12,8,8,0,2,100.0,0,0,0,0,0,0,0,0,0,0,0.0,0.0
54.py,2,2,2,0,1,88.5574946685516,1,2,3,1,2,3,3,4.754887502163469,0.5,2.3774437510817346,0.0015849625007211565,0.1320802083934297
160.py,6,6,6,0,2,72.12377618647942,2,6,8,4,7,11,8,33.0,1.1666666666666667,38.5,0.011,2.138888888888889
27.py,2,2,2,0,1,100.0,0,0,0,0,0,0,0,0,0,0,0.0,0.0
51.py,3,3,3,0,3,84.44724042799471,1,2,3,1,2,3,3,4.754887502163469,0.5,2.3774437510817346,0.0015849625007211565,0.1320802083934297
159.py,4,4,4,0,1,78.39554672677042,2,4,6,2,4,6,6,15.509775004326936,1.0,15.509775004326936,0.005169925001442312,0.861654166907052
37.py,6,6,6,0,4,74.15078956223692,2,4,6,2,4,6,6,15.509775004326936,1.0,15.509775004326936,0.005169925001442312,0.861654166907052
92.py,5,5,5,0,5,70.79800899916958,3,9,12,7,15,22,12,78.86917501586544,2.5,197.1729375396636,0.026289725005288478,10.954052085536865
72.py,4,4,4,0,3,75.39721260413943,4,7,11,4,7,11,11,38.053747805010275,2.0,76.10749561002055,0.012684582601670092,4.228194200556697
33.py,7,7,7,0,3,76.42020806643173,1,2,3,1,2,3,3,4.754887502163469,0.5,2.3774437510817346,0.0015849625007211565,0.1320802083934297
19.py,6,6,6,0,1,100.0,0,0,0,0,0,0,0,0,0,0,0.0,0.0
100.py,2,2,2,0,2,84.82770130283538,2,4,6,2,4,6,6,15.509775004326936,1.0,15.509775004326936,0.005169925001442312,0.861654166907052
126.py,2,2,2,0,2,83.14190875538385,2,6,8,3,6,9,8,27.0,1.0,27.0,0.009,1.5
52.py,2,2,2,0,2,88.42299174457497,1,2,3,1,2,3,3,4.754887502163469,0.5,2.3774437510817346,0.0015849625007211565,0.1320802083934297
50.py,2,2,2,0,2,81.83377702795524,3,8,11,4,8,12,11,41.51317942364757,1.5,62.26976913547136,0.01383772647454919,3.4594316186372978
119.py,24,19,19,6,9,82.80392909219296,6,14,20,11,22,33,20,142.62362713128297,4.714285714285714,672.3685279046198,0.04754120904376099,37.35380710581221
108.py,2,2,2,0,4,88.15398589662178,1,2,3,1,2,3,3,4.754887502163469,0.5,2.3774437510817346,0.0015849625007211565,0.1320802083934297
163.py,4,4,4,0,3,76.27320603401535,3,6,9,3,6,9,9,28.529325012980813,1.5,42.793987519471216,0.009509775004326938,2.377443751081734
38.py,6,6,6,0,4,68.55502039697015,5,10,15,9,16,25,15,97.67226489021297,4.0,390.6890595608519,0.03255742163007099,21.70494775338066
5.py,5,6,5,0,3,80.51411184771567,1,1,2,1,1,2,2,2.0,0.5,1.0,0.0006666666666666666,0.05555555555555555
142.py,10,10,10,0,5,62.070007110630954,6,16,22,12,24,36,22,160.5395382709427,4.5,722.4279222192422,0.05351317942364757,40.134884567735675
4.py,7,5,5,0,2,74.46125971657607,2,6,8,3,6,9,8,27.0,1.0,27.0,0.009,1.5
58.py,2,2,2,0,1,100.0,0,0,0,0,0,0,0,0,0,0,0.0,0.0
93.py,17,14,14,1,5,76.93506407303555,3,10,13,6,12,18,13,66.60791492653966,1.8,119.8942468677714,0.022202638308846556,6.660791492653967
29.py,2,2,2,0,3,100.0,0,0,0,0,0,0,0,0,0,0,0.0,0.0
127.py,15,13,13,0,6,60.472530035883686,7,12,19,9,18,27,19,114.6940428629768,5.25,602.1437250306282,0.03823134762099227,33.45242916836823
104.py,6,6,6,0,4,74.15078956223692,2,4,6,2,4,6,6,15.509775004326936,1.0,15.509775004326936,0.005169925001442312,0.861654166907052
99.py,12,12,12,0,4,62.1702992238476,5,11,16,8,15,23,16,92.0,3.409090909090909,313.6363636363636,0.030666666666666665,17.424242424242422
68.py,6,7,6,0,4,72.69041470071554,2,4,6,2,4,6,6,15.509775004326936,1.0,15.509775004326936,0.005169925001442312,0.861654166907052
135.py,5,5,5,0,3,73.20852939104878,3,5,8,5,8,13,8,39.0,2.4,93.6,0.013,5.199999999999999
71.py,9,7,7,2,4,90.24861629846362,8,21,29,18,36,54,29,262.33097373688895,6.857142857142857,1798.8409627672384,0.08744365791229632,99.93560904262435
89.py,2,2,2,0,3,81.82261122439607,3,7,10,4,8,12,10,39.863137138648355,1.7142857142857142,68.33680652339717,0.013287712379549451,3.796489251299843
20.py,14,10,10,6,3,94.33322286615667,3,9,12,6,12,18,12,64.52932501298082,2.0,129.05865002596164,0.02150977500432694,7.169925001442313
87.py,8,9,8,0,4,71.19030148524578,2,3,5,2,3,5,5,11.60964047443681,1.0,11.60964047443681,0.0038698801581456034,0.6449800263576005
25.py,12,12,12,0,4,63.48055159652652,6,4,10,6,12,18,10,59.794705707972525,9.0,538.1523513717527,0.019931568569324175,29.897352853986263
117.py,26,13,13,10,5,93.36119223895716,3,5,8,3,6,9,8,27.0,1.8,48.6,0.009,2.7
148.py,19,10,10,5,4,94.60734753087051,4,8,12,5,10,15,12,53.77443751081735,2.5,134.43609377704337,0.017924812503605784,7.468671876502409
62.py,2,2,2,0,2,88.42299174457497,1,2,3,1,2,3,3,4.754887502163469,0.5,2.3774437510817346,0.0015849625007211565,0.1320802083934297
134.py,14,9,9,4,5,95.11098271666285,4,8,12,6,9,15,12,53.77443751081735,2.25,120.99248439933903,0.017924812503605784,6.721804688852169
42.py,2,2,2,0,2,88.42299174457497,1,2,3,1,2,3,3,4.754887502163469,0.5,2.3774437510817346,0.0015849625007211565,0.1320802083934297
138.py,5,5,5,0,3,73.01862506517085,4,7,11,4,8,12,11,41.51317942364757,2.2857142857142856,94.88726725405158,0.01383772647454919,5.27151484744731
24.py,5,5,5,0,3,73.54898781898997,4,5,9,4,7,11,9,34.86917501586544,2.8,97.63369004442322,0.011623058338621813,5.424093891356845
144.py,6,4,4,2,1,100.0,2,4,6,2,4,6,6,15.509775004326936,1.0,15.509775004326936,0.005169925001442312,0.861654166907052
120.py,2,3,2,0,2,82.32107511111553,2,2,4,2,3,5,4,10.0,1.5,15.0,0.0033333333333333335,0.8333333333333334
114.py,9,7,7,0,2,76.55471099040834,1,2,3,1,2,3,3,4.754887502163469,0.5,2.3774437510817346,0.0015849625007211565,0.1320802083934297
0.py,11,7,7,0,3,69.95433047022944,3,7,10,4,8,12,10,39.863137138648355,1.7142857142857142,68.33680652339717,0.013287712379549451,3.796489251299843
17.py,4,5,4,0,2,100.0,0,0,0,0,0,0,0,0,0,0,0.0,0.0
32.py,5,4,3,0,1,100.0,0,0,0,0,0,0,0,0,0,0,0.0,0.0
101.py,2,2,2,0,3,88.28848882059837,1,2,3,1,2,3,3,4.754887502163469,0.5,2.3774437510817346,0.0015849625007211565,0.1320802083934297
41.py,2,2,2,0,1,88.5574946685516,1,2,3,1,2,3,3,4.754887502163469,0.5,2.3774437510817346,0.0015849625007211565,0.1320802083934297
35.py,2,2,2,0,1,100.0,0,0,0,0,0,0,0,0,0,0,0.0,0.0
90.py,7,7,7,0,2,76.55471099040834,1,2,3,1,2,3,3,4.754887502163469,0.5,2.3774437510817346,0.0015849625007211565,0.1320802083934297
18.py,10,10,10,0,3,66.10654238431758,4,6,10,5,9,14,10,46.50699332842308,3.0,139.52097998526924,0.01550233110947436,7.75116555473718
116.py,2,3,2,0,1,100.0,0,0,0,0,0,0,0,0,0,0,0.0,0.0
66.py,2,2,2,0,3,100.0,0,0,0,0,0,0,0,0,0,0,0.0,0.0
36.py,6,6,6,0,4,69.63245789928568,4,10,14,6,12,18,14,68.53238859703687,2.4,164.4777326328885,0.022844129532345624,9.13765181293825
47.py,8,8,8,0,2,66.48425580962163,4,8,12,8,16,24,12,86.03910001730776,4.0,344.15640006923104,0.028679700005769252,19.11980000384617
16.py,2,2,2,0,2,100.0,0,0,0,0,0,0,0,0,0,0,0.0,0.0
63.py,12,9,9,0,5,65.274559393729,3,10,13,7,14,21,13,77.70923408096293,2.1,163.18939157002217,0.025903078026987644,9.066077309445676
26.py,6,6,6,0,3,77.88058292795313,1,2,3,1,2,3,3,4.754887502163469,0.5,2.3774437510817346,0.0015849625007211565,0.1320802083934297
150.py,17,15,15,0,8,60.262561633601194,4,8,12,7,14,21,12,75.28421251514429,3.5,263.494743803005,0.025094737505048096,14.638596877944723
13.py,4,4,4,0,2,78.58737599248319,2,3,5,2,4,6,5,13.931568569324174,1.3333333333333333,18.575424759098897,0.004643856189774725,1.0319680421721609
161.py,5,6,5,0,5,76.0294740244271,2,2,4,2,2,4,4,8.0,1.0,8.0,0.0026666666666666666,0.4444444444444444
109.py,6,7,6,0,3,70.2189264704318,3,7,10,4,7,11,10,36.541209043760986,1.5,54.81181356564148,0.012180403014586996,3.0451007536467487
151.py,2,2,2,0,5,79.66296815958566,6,9,15,6,13,19,15,74.23092131656186,4.333333333333333,321.6673257051014,0.024743640438853954,17.870406983616746
130.py,8,9,8,0,3,65.54356524168223,5,8,13,8,13,21,13,77.70923408096293,4.0625,315.6937634539119,0.025903078026987644,17.538542414106217
67.py,3,3,3,0,3,81.1782821759445,1,4,5,2,4,6,5,13.931568569324174,0.5,6.965784284662087,0.004643856189774725,0.3869880158145604
45.py,2,2,2,0,1,85.28853641650139,1,4,5,2,4,6,5,13.931568569324174,0.5,6.965784284662087,0.004643856189774725,0.3869880158145604
88.py,10,10,10,0,3,66.00376387542786,5,8,13,5,8,13,13,48.105716335834195,2.5,120.26429083958548,0.016035238778611398,6.681349491088082
152.py,2,2,2,0,2,88.42299174457497,1,2,3,1,2,3,3,4.754887502163469,0.5,2.3774437510817346,0.0015849625007211565,0.1320802083934297
15.py,2,2,2,0,1,88.5574946685516,1,2,3,1,2,3,3,4.754887502163469,0.5,2.3774437510817346,0.0015849625007211565,0.1320802083934297
125.py,11,11,11,0,6,62.81937869003807,6,13,19,7,14,21,19,89.20647778231529,3.230769230769231,288.20554360440326,0.029735492594105097,16.011419089133515
78.py,3,3,3,0,2,84.58174335197131,1,2,3,1,2,3,3,4.754887502163469,0.5,2.3774437510817346,0.0015849625007211565,0.1320802083934297
145.py,3,3,2,0,1,100.0,0,0,0,0,0,0,0,0,0,0,0.0,0.0
157.py,3,3,3,0,1,77.4484663740452,3,8,11,5,10,15,11,51.89147427955947,1.875,97.296514274174,0.01729715809318649,5.405361904120777
6.py,12,12,12,0,5,64.88901391430564,3,5,8,4,8,12,8,36.0,2.4,86.39999999999999,0.012,4.8
1.py,18,15,15,0,5,61.2320571337837,3,7,10,6,12,18,10,59.794705707972525,2.5714285714285716,153.75781467764364,0.019931568569324175,8.542100815424646
46.py,7,7,7,0,3,65.813279927725,4,16,20,12,24,36,20,155.58941141594505,3.0,466.76823424783515,0.05186313713864835,25.931568569324174
162.py,6,6,6,0,2,78.01508585192973,1,2,3,1,2,3,3,4.754887502163469,0.5,2.3774437510817346,0.0015849625007211565,0.1320802083934297
96.py,6,6,6,0,4,74.15078956223692,2,4,6,2,4,6,6,15.509775004326936,1.0,15.509775004326936,0.005169925001442312,0.861654166907052
153.py,7,7,7,0,1,76.68921391438496,1,2,3,1,2,3,3,4.754887502163469,0.5,2.3774437510817346,0.0015849625007211565,0.1320802083934297
122.py,2,3,2,0,3,80.1322140037762,3,4,7,3,4,7,7,19.651484454403228,1.5,29.47722668160484,0.00655049481813441,1.6376237045336022
30.py,2,2,2,0,3,88.28848882059837,1,2,3,1,2,3,3,4.754887502163469,0.5,2.3774437510817346,0.0015849625007211565,0.1320802083934297
95.py,9,7,9,0,9,67.59490571101736,4,11,15,6,11,17,15,66.41714012534482,2.0,132.83428025068963,0.02213904670844827,7.379682236149424
83.py,4,4,4,0,2,73.27394983861346,4,10,14,7,14,21,14,79.95445336320968,2.8,223.8724694169871,0.026651484454403226,12.437359412054839
80.py,7,7,7,0,6,65.86448753980045,5,15,20,10,21,31,20,133.97977094150824,3.5,468.9291982952788,0.04465992364716941,26.05162212751549
76.py,7,7,7,0,3,69.27576528494643,4,6,10,5,10,15,10,49.82892142331044,3.3333333333333335,166.09640474436813,0.016609640474436815,9.227578041353786
39.py,24,21,21,0,1,55.991494061237056,6,13,19,11,22,33,19,140.1816079436383,5.076923076923077,711.6912403292406,0.04672720264787944,39.53840224051336
129.py,31,28,28,0,5,52.19248769213601,8,17,25,13,23,36,25,167.17882283189007,5.411764705882353,904.7324529725817,0.05572627427729669,50.262914054032315
154.py,3,4,3,0,3,78.1265408788172,2,4,6,2,4,6,6,15.509775004326936,1.0,15.509775004326936,0.005169925001442312,0.861654166907052
21.py,5,5,5,0,2,74.66308527157166,2,5,7,3,6,9,7,25.26619429851844,1.2,30.319433158222125,0.008422064766172813,1.6844129532345624
2.py,2,2,2,0,1,88.5574946685516,1,2,3,1,2,3,3,4.754887502163469,0.5,2.3774437510817346,0.0015849625007211565,0.1320802083934297
118.py,7,8,7,0,5,67.41358910604698,4,9,13,5,10,15,13,55.506595772116384,2.2222222222222223,123.34799060470309,0.01850219859070546,6.852666144705727
143.py,11,11,11,0,3,64.66566486971934,5,8,13,5,10,15,13,55.506595772116384,3.125,173.4581117878637,0.01850219859070546,9.636561765992427
106.py,12,12,12,0,4,63.248824245526315,4,8,12,6,12,18,12,64.52932501298082,3.0,193.58797503894246,0.02150977500432694,10.75488750216347
75.py,27,25,25,0,7,52.44178703858697,6,16,22,15,30,45,22,200.67442283867837,5.625,1128.793628467566,0.06689147427955945,62.71075713708699
74.py,7,7,7,0,4,76.28570514245513,1,2,3,1,2,3,3,4.754887502163469,0.5,2.3774437510817346,0.0015849625007211565,0.1320802083934297
56.py,10,10,10,0,6,63.976811337405124,4,11,15,7,14,21,15,82.0447025077789,2.5454545454545454,208.84106092889172,0.02734823416925963,11.602281162716206
132.py,16,14,14,0,7,61.462346937675825,4,9,13,6,11,17,13,62.907475208398566,2.4444444444444446,153.7738282871965,0.02096915840279952,8.542990460399805
10.py,12,12,10,0,4,62.20134358739931,5,9,14,9,16,25,14,95.18387305144009,4.444444444444445,423.0394357841782,0.03172795768381336,23.502190876898787
61.py,10,10,10,3,6,94.67347217900178,2,4,6,3,5,8,6,20.67970000576925,1.25,25.84962500721156,0.006893233335256416,1.43609027817842
149.py,3,4,3,0,3,78.1265408788172,2,4,6,2,4,6,6,15.509775004326936,1.0,15.509775004326936,0.005169925001442312,0.861654166907052
